"Year","Occupation","Total_Number","Men_Number","Women_Number","Total_MedianEarnings","Men_MedianEarnings","Women_MedianEarnings"
2013,"..Office and Administrative Support Occupations:",13261018,3706820,9554198,35120,38713,33637
2013,"..Education, Legal, Community Service, Arts, and Media Occupations:",9946980,3873198,6073782,49461,56887,45482
2013,"..Healthcare Practitioners and Technical Occupations:",5784959,1647689,4137270,61014,80723,56710
2013,"..Sales and Related Occupations:",9763412,5776608,3986804,41300,50259,31747
2013,"...Education, Training, and Library Occupations:",5123204,1512120,3611084,47331,55349,44667
2013,"...Business and Financial Operations Occupations:",5677671,2607609,3070062,60692,70670,52958
2013,"...Secretaries and administrative assistants",2402826,112008,2290818,35814,40599,35677
2013,"..Healthcare Support Occupations:",2235372,331472,1903900,27158,30838,26743
2013,"..Personal Care and Service Occupations:",2530732,667947,1862785,24051,30217,22294
2013,"...Registered nurses",2061647,238183,1823464,62265,67990,61946
2013,"Elementary and middle school teachers",2282888,503434,1779454,48874,51986,47521
2013,"..Production Occupations:",6900369,5123473,1776896,35478,39170,26544
2013,"..Food Preparation and Serving Related Occupations:",3428600,1846291,1582309,21343,22483,20049
2013,"..Computer, Engineering, and Science Occupations:",6587606,5025859,1561747,75222,78480,65160
2013,"...Nursing, psychiatric, and home health aides",1397113,219944,1177169,25909,30408,25362
2013,"...First-line supervisors of retail sales workers",2563806,1465356,1098450,38265,44856,31897
2013,"...Community and Social Service Occupations:",1772184,685908,1086276,42023,43927,41485
2013,"..Building and Grounds Cleaning and Maintenance Occupations:",3334604,2253763,1080841,25267,27873,20844
2013,"...Customer service representatives",1589129,535845,1053284,31913,35505,31152
2013,"....Managers, all other",3034121,2056582,977539,75912,81462,63917
2013,"Accountants and auditors",1651199,683411,967788,61270,72805,54720
2013,"...Computer and mathematical occupations:",3326898,2491163,835735,76739,80509,69795
2013,"...Bookkeeping, accounting, and auditing clerks",874662,114995,759667,36798,41490,36372
2013,"...Cashiers",1042284,321457,720827,20562,22257,19736
2013,"...Arts, Design, Entertainment, Sports, and Media Occupations:",1675400,984006,691394,50909,52617,47086
2013,"...Legal Occupations:",1376192,691164,685028,83735,116689,61432
2013,"...First-line supervisors of office and administrative support workers",1126495,444538,681957,46725,54066,42369
2013,"...Retail salespersons",1668480,1012539,655941,31615,37143,26140
2013,"...Maids and housekeeping cleaners",737561,127620,609941,20422,24397,19752
2013,"...Office clerks, general",729066,127739,601327,32439,36371,32155
2013,"...Receptionists and information clerks",657793,63049,594744,27345,29454,27222
2013,"....Financial managers",990611,460842,529769,70456,90278,57406
2013,"...Childcare workers",536474,29929,506545,20056,21832,19931
2013,"Social workers",627085,124774,502311,41940,42821,41795
2013,"..Protective Service Occupations:",2494739,1998665,496074,49316,51159,40760
2013,"...Personal care aides",576620,105440,471180,21898,24244,21557
2013,"...Waiters and waitresses",680777,243097,437680,20980,23802,19524
2013,"....Education administrators",708239,272330,435909,66889,78115,60580
2013,"..Material Moving Occupations:",2360476,1931262,429214,28861,30415,23419
2013,"Human resources workers",571108,158154,412954,54989,63034,51765
2013,"...Cooks",1111982,700025,411957,20319,21063,18581
2013,"...Life, Physical, and Social Science Occupations:",946702,539201,407501,62089,66913,57617
2013,"...Licensed practical and licensed vocational nurses",442709,43277,399432,40031,42442,39562
2013,"...Hairdressers, hairstylists, and cosmetologists",434564,52142,382422,24855,31224,23943
2013,"Postsecondary teachers",836986,457786,379200,65463,71414,60359
2013,"....Medical and health services managers",546042,171661,374381,69563,84450,64765
2013,"...Janitors and building cleaners",1519858,1149371,370487,26845,29685,21592
2013,".Natural Resources, Construction, and Maintenance Occupations:",9447149,9083555,363594,40492,40696,30351
2013,"...Billing and posting clerks",386492,39847,346645,32487,37351,32267
2013,"..Transportation Occupations:",3637658,3296719,340939,40594,41222,30304
2013,"Counselors",482328,146849,335479,42349,42299,42369
2013,"....Food service managers",740359,407357,333002,36586,41164,31578
2013,"Teacher assistants",371321,44030,327291,21125,25873,20748
2013,"...Office and administrative support workers, all other",428493,103715,324778,38662,44833,36981
2013,"...Architecture and Engineering Occupations:",2314006,1995495,318511,76706,79244,64961
2013,"....Marketing and sales managers",754514,440078,314436,78455,91998,65040
2013,"Preschool and kindergarten teachers",316025,8298,307727,24347,30067,24257
2013,"...Medical assistants",330718,24072,306646,28760,29894,28661
2013,"Secondary school teachers",541598,240315,301283,50810,52819,49048
2013,"....General and operations managers",977284,681627,295657,73557,81041,60759
2013,"Lawyers",852860,568201,284659,120617,127337,101640
2013,"...Miscellaneous assemblers and fabricators",766770,484475,282295,30561,32026,26899
2013,"...First-line supervisors of non-retail sales workers",1030338,751705,278633,60403,61556,53770
2013,"...Stock clerks and order fillers",814645,536330,278315,26489,27032,25493
2013,"...Health practitioner support technologists and technicians",350939,73031,277908,31788,35640,31292
2013,"...Sales representatives, wholesale and manufacturing",1129716,857038,272678,61355,63861,51986
2013,"Paralegals and legal assistants",307815,45422,262393,46562,50498,46061
2013,"...Real estate brokers and sales agents",513527,253865,259662,50914,60775,42294
2013,"Designers",552419,303391,249028,50461,55658,44269
2013,"Management analysts",589692,346499,243193,80220,89151,72006
2013,"...Physicians and surgeons",737546,495061,242485,182232,202533,140036
2013,"Chief executives",1024259,782400,241859,120254,126142,95921
2013,"...Insurance claims and policy processing clerks",289881,54892,234989,36090,40293,35574
2013,"...Production workers, all other",881828,653314,228514,32491,36237,26505
2013,"...Inspectors, testers, sorters, samplers, and weighers",623203,397579,225624,38673,43551,31043
2013,"....Property, real estate, and community association managers",414232,203818,210414,47936,57059,41743
2013,"...Tellers",233474,26160,207314,25260,25564,25222
2013,"...Laborers and freight, stock, and material movers, hand",1211599,1009313,202286,29722,30531,24953
2013,"...First-line supervisors of food preparation and serving workers",374711,176476,198235,24828,27453,22506
2013,"...Insurance sales agents",429706,235417,194289,50238,61639,41250
2013,"Other teachers and instructors",359794,169655,190139,43740,50250,40132
2013,"...Word processors and typists",217182,29544,187638,32507,36294,32208
2013,"...Data entry keyers",235336,51507,183829,31745,35544,31236
2013,"Software developers, applications and systems software",924888,741308,183580,94025,96868,83808
2013,"....Social and community service managers",279952,96503,183449,55473,62367,51933
2013,"....Human resources managers",307004,125240,181764,67669,75328,64662
2013,"...Clinical laboratory technologists and technicians",245751,65488,180263,45326,46941,44623
2013,"...Diagnostic related technologists and technicians",237127,74756,162371,55482,60703,52950
2013,"Computer systems analysts",441538,280626,160912,75886,81174,69346
2013,"...Food preparation workers",302338,142050,160288,19063,19870,18376
2013,"Claims adjusters, appraisers, examiners, and investigators",257730,98587,159143,51134,60097,46520
2013,"Credit counselors and loan officers",285649,130778,154871,54535,69726,46394
2013,"...Production, planning, and expediting clerks",267453,115532,151921,44865,56437,37246
2013,"...Sales representatives, services, all other",497043,346088,150955,60174,65763,48984
2013,"...Security guards and gaming surveillance officers",668775,518657,150118,30421,30546,29883
2013,"...Packers and packagers, hand",273503,123631,149872,21661,22711,20876
2013,"...First-line supervisors of production and operating workers",802370,656622,145748,51796,54494,40815
2013,"...File clerks",189148,44248,144900,32442,35594,31976
2013,"Special education teachers",165928,25578,140350,47264,46932,47378
2013,"..Installation, Maintenance, and Repair Occupations:",3860624,3721190,139434,43450,43781,40347
2013,"...Dental assistants",147438,8460,138978,30308,26823,30399
2013,"....Computer and information systems managers",489048,354369,134679,99167,101318,90940
2013,"Market research analysts and marketing specialists",230432,102417,128015,128015,80508,60673
2013,"...Dispatchers",235227,108901,126326,36730,41363,34067
2013,"...Miscellaneous personal appearance workers",159831,33519,126312,21724,22047,21632
2013,"...Shipping, receiving, and traffic clerks",445945,322035,123910,30682,31401,27939
2013,"...Payroll and timekeeping clerks",138447,15290,123157,39268,41838,38923
2013,"Computer support specialists",458736,339470,119266,52063,53960,49001
2013,"..Construction and Extraction Occupations:",4960836,4841705,119131,40003,40078,33236
2013,"Business operations specialists, all other",211970,98399,113571,56945,67442,51378
2013,"Purchasing agents, except wholesale, retail, and farm products",220927,107988,112939,54632,60957,50058
2013,"Miscellaneous legal support workers",148521,40412,108109,46748,60958,43663
2013,"...Pharmacists",205734,98972,106762,116468,120792,111809
2013,"...Driver/sales workers and truck drivers",2472147,2365886,106261,40588,40865,27657
2013,"...Bailiffs, correctional officers, and jailers",387955,281897,106058,42043,45432,37042
2013,"...Packaging and filling machine operators and tenders",198721,92772,105949,25434,28528,22809
2013,"..Farming, Fishing, and Forestry Occupations:",625689,520660,105029,25086,26271,18998
2013,"...Bus drivers",275991,174830,101161,32725,37569,27180
2013,"...Bill and account collectors",142343,42195,100148,33453,36784,32234
2013,"...Bartenders",203401,104261,99140,26403,28682,23849
2013,"...Sewing machine operators",134443,36754,97689,20788,22855,20430
2013,"Compliance officers",193020,95524,97496,62311,66724,60054
2013,"Librarians",111952,19727,92225,48892,51879,48005
2013,"...Loan interviewers and clerks",116281,25344,90937,39905,41750,38807
2013,"...Postal service mail carriers",251980,161216,90764,55923,57073,52085
2013,"...Recreation and fitness workers",163532,72807,90725,31044,35636,28203
2013,"...Physical therapists",136392,49118,87274,72260,80411,70509
2013,"Personal financial advisors",283136,196273,86863,82142,98126,60359
2013,"...Police and sheriff's patrol officers",623338,539272,84066,61313,61694,56541
2013,"Wholesale and retail buyers, except farm products",170412,86522,83890,42170,41619,42990
2013,"...Sales and related workers, all other",186390,103486,82904,51489,61045,44956
2013,"...Medical records and health information technicians",90186,9831,80355,31530,36960,31126
2013,"....Purchasing managers",175540,96499,79041,71237,81528,62785
2013,"Psychologists",115139,37071,78068,66764,76903,62146
2013,"Computer occupations, all other",354952,277889,77063,66550,66971,65329
2013,"...Advertising sales agents",155726,78938,76788,51283,60522,45378
2013,"Computer programmers",374314,298175,76139,80512,81508,75088
2013,"...Miscellaneous therapists, including exercise physiologists",99008,24425,74583,46743,50295,46040
2013,"Social and human service assistants",94377,20048,74329,35643,34967,35766
2013,"...Speech-language pathologists",77904,3626,74278,60695,68346,60552
2013,"...Combined food preparation and serving workers, including fast food",114984,41054,73930,19623,20150,19325
2013,"...Nurse practitioners",81140,8332,72808,91766,106141,91276
2013,"...Nonfarm animal caretakers",103783,31762,72021,24547,25025,24401
2013,"...Information and record clerks, all other",85226,14182,71044,36818,41589,36352
2013,"...Securities, commodities, and financial services sales agents",226082,157344,68738,76524,93795,51284
2013,"...Miscellaneous agricultural workers",451767,383111,68656,23324,24602,17713
2013,"...Metal workers and plastic workers, all other",317561,249208,68353,32471,35514,26963
2013,"...Interviewers, except eligibility and loan",84440,16624,67816,31180,35424,30395
2013,"...Healthcare support workers, all other, including medical equipment preparers",94391,28907,65484,28604,32130,26452
2013,"...Laundry and dry-cleaning workers",111926,47034,64892,21137,24752,19203
2013,"...Physician assistants",100572,35720,64852,81522,93791,76396
2013,"Physical scientists, all other",171530,106686,64844,74592,85195,61217
2013,"...Phlebotomists",75727,11061,64666,31062,34855,30732
2013,"...Bakers",131066,67099,63967,23666,26114,22040
2013,"Engineering technicians, except drafters",371566,307644,63922,54623,56847,43517
2013,"Meeting, convention, and event planners",78856,15208,63648,47088,47876,46973
2013,"Writers and authors",121198,57902,63296,53964,60192,51219
2013,"Other education, training, and library workers",88624,26398,62226,51516,55834,50756
2013,"Insurance underwriters",94336,33432,60904,58402,75372,52283
2013,"Medical scientists",112826,53210,59616,71375,80113,66860
2013,"...First-line supervisors of housekeeping and janitorial workers",182546,123092,59454,35629,41180,26860
2013,"Public relations specialists",97408,38545,58863,63966,76638,58483
2013,"...Dental hygienists",61825,3320,58505,52043,53709,51972
2013,"Operations research analysts",123636,65206,58430,77172,86748,68925
2013,"Editors",117721,59523,58198,52746,55899,51884
2013,"...Financial clerks, all other",95267,37438,57829,50176,67732,42122
2013,"...Court, municipal, and license clerks",70610,13198,57412,36977,42192,35585
2013,"...Miscellaneous health technologists and technicians",90586,33686,56900,41660,47830,39277
2013,"Training and development specialists",105954,50856,55098,52417,59310,50024
2013,"...Electrical, electronics, and electromechanical assemblers",116834,61800,55034,30144,31243,27385
2013,"...Dietitians and nutritionists",61437,7250,54187,47997,49001,47717
2013,"....Farmers, ranchers, and other agricultural managers",499775,446121,53654,40638,41691,25310
2013,"...Occupational therapists",59239,6903,52336,68270,75740,67164
2013,"...Respiratory therapists",84482,32234,52248,54303,60677,51864
2013,"...Order clerks",85033,33587,51446,31732,33757,31216
2013,"...First-line supervisors of personal service workers",98491,47150,51341,33932,40006,30871
2013,"...Eligibility interviewers, government programs",65971,14730,51241,41398,50400,40071
2013,"...Chefs and head cooks",303612,252537,51075,30267,30810,25534
2013,"Engineers, all other",439749,388864,50885,90913,91800,81702
2013,"Clergy",339774,289076,50698,44422,45350,40754
2013,"...Hotel, motel, and resort desk clerks",76241,27058,49183,21564,21995,21329
2013,"....Lodging managers",96419,47382,49037,41824,50610,36533
2013,"...Butchers and other meat, poultry, and fish processing workers",203134,154517,48617,26999,29333,22876
2013,"...Reservation and transportation ticket agents and travel clerks",86373,38370,48003,36454,40755,35344
2013,"...Postal service clerks",94064,47005,47059,53357,54166,52574
2013,"...Emergency medical technicians and paramedics",157684,110916,46768,41670,43647,37023
2013,"Miscellaneous life, physical, and social science technicians",100831,55051,45780,44561,48138,40792
2013,"Fundraisers",63985,18678,45307,60802,69292,57730
2013,"...Food servers, nonrestaurant",69554,24402,45152,23025,23729,22775
2013,"...Human resources assistants, except payroll and timekeeping",54580,9723,44857,40081,42293,37643
2013,"Producers and directors",117967,73980,43987,63715,62368,66226
2013,"...Massage therapists",57261,13680,43581,29253,29272,29240
2013,"Miscellaneous community and social service specialists, including health educators and community health workers",68388,25669,42719,41900,47966,39620
2013,"Artists and related workers",116825,75425,41400,49197,54669,37261
2013,"....Industrial production managers",218198,177200,40998,72414,74623,65033
2013,"Probation officers and correctional treatment specialists",83568,42704,40864,45909,47561,44385
2013,"Web developers",136446,95672,40774,60056,61566,53995
2013,"Database administrators",101323,61969,39354,75824,84609,61378
2013,"Compensation, benefits, and job analysis specialists",53127,13895,39232,50968,61089,47927
2013,"....Administrative services managers",109703,72873,36830,62187,66579,55079
2013,"...Travel agents",46577,9963,36614,37233,40408,36746
2013,"Industrial engineers, including health and safety",172367,136669,35698,75131,76487,66498
2013,"...Hosts and hostesses, restaurant, lounge, and coffee shop",42666,7262,35404,18040,23444,17260
2013,"Network and computer systems administrators",195372,160376,34996,67246,68363,61699
2013,"....Construction managers",469706,434849,34857,68101,69556,62198
2013,"...Grounds maintenance workers",728064,693654,34410,23545,23639,21996
2013,"...Computer operators",78265,43996,34269,42028,48966,37288
2013,"...Printing workers, except prepress technicians and workers",169498,135466,34032,34992,36916,26679
2013,"Logisticians",97563,63756,33807,52109,54698,50410
2013,"....Transportation, storage, and distribution managers",185512,151841,33671,52058,52017,52259
2013,"Tax examiners and collectors, and revenue agents",50960,17617,33343,49380,66754,45704
2013,"...Flight attendants",43455,10842,32613,42687,51594,41168
2013,"...Physical therapist assistants and aides",44581,12122,32459,41994,46313,41098
2013,"Financial specialists, all other",58785,26520,32265,61323,81859,48869
2013,"Photographers",80489,48494,31995,38052,44513,30455
2013,"...Postal service mail sorters, processors, and processing machine operators",61856,30285,31571,53497,54885,52637
2013,"Architects, except naval",145439,114341,31098,71305,75395,60518
2013,"Athletes, coaches, umpires, and related workers",114456,83451,31005,43373,46602,36682
2013,"...Gaming services workers",64709,33752,30957,36477,37441,35023
2013,"...Dining room and cafeteria attendants and bartender helpers",86785,56021,30764,19562,20378,17663
2013,"...Medical transcriptionists",31868,1221,30647,31933,40429,31772
2013,"...Food processing workers, all other",95533,65550,29983,31292,32439,27983
2013,"...Medical, dental, and ophthalmic laboratory technicians",64031,34102,29929,33779,37346,30704
2013,"...Tailors, dressmakers, and sewers",42018,12251,29767,22621,27459,21759
2013,"...Detectives and criminal investigators",117375,87855,29520,71169,75025,59386
2013,"...Supervisors of transportation and material moving workers",185456,156031,29425,50107,51339,40904
2013,"...Private detectives and investigators",68657,39367,29290,50892,56439,45436
2013,"...Credit authorizers, checkers, and clerks",40119,10893,29226,36579,50853,35037
2013,"Civil engineers",257802,228722,29080,81233,81911,71854
2013,"Biological scientists",60924,31860,29064,57426,57653,57107
2013,"...Industrial truck and tractor operators",428059,399291,28768,31000,31002,30981
2013,"...Veterinarians",57599,29223,28376,86490,96582,80681
2013,"Chemists and materials scientists",71161,42953,28208,69780,71853,65582
2013,"...Food batchmakers",56485,28317,28168,27131,31811,24268
2013,"....Public relations and fundraising managers",44198,16141,28057,74114,90071,66052
2013,"...Other healthcare practitioners and technical occupations",72636,44786,27850,55942,60786,47405
2013,"...Telemarketers",44182,16477,27705,25628,26440,25257
2013,"...Library assistants, clerical",33132,5578,27554,28558,30889,27952
2013,"Miscellaneous media and communication workers",45120,17870,27250,42033,46135,40256
2013,"...Opticians, dispensing",39047,11901,27146,35580,42128,32267
2013,"Tax preparers",51485,24538,26947,56047,70641,47997
2013,"Budget analysts",41799,14880,26919,70429,78667,65830
2013,"...Cleaners of vehicles and equipment",197864,171164,26700,23751,23605,24793
2013,"...Weighers, measurers, checkers, and samplers, recordkeeping",61712,35803,25909,35476,40651,30345
2013,"Appraisers and assessors of real estate",75414,49592,25822,55227,61056,45643
2013,"...Construction laborers",986693,961321,25372,31027,31066,27927
2013,"....Advertising and promotions managers",43015,17775,25240,61371,75190,55860
2013,"...First-line supervisors of gaming workers",58437,33458,24979,41245,45980,37178
2013,"...Welding, soldering, and brazing workers",488957,464041,24916,38137,39281,26893
2013,"...Mail clerks and mail machine operators, except postal service",54267,29670,24597,29276,30238,28308
2013,"Technical writers",43977,19964,24013,69242,75598,61511
2013,"Judges, magistrates, and other judicial workers",55881,32209,23672,100619,115636,83173
2013,"News analysts, reporters and correspondents",52566,29289,23277,50711,55156,45994
2013,"...Dentists",97562,74382,23180,141557,151071,102460
2013,"...Door-to-door sales workers, news and street vendors, and related workers",55838,33591,22247,25624,29469,23312
2013,"Religious workers, all other",41694,19827,21867,36496,40454,35612
2013,"Drafters",124267,102941,21326,51609,52296,47123
2013,"...Counter and rental clerks",45567,24387,21180,27373,27449,27194
2013,"...Telephone operators",28046,6893,21153,29587,31822,27360
2013,"....Training and development managers",41185,20111,21074,74735,80754,71091
2013,"...Graders and sorters, agricultural products",32773,11741,21032,20420,23490,18099
2013,"Financial analysts",65367,44484,20883,84140,100081,63424
2013,"...Taxi drivers and chauffeurs",196209,175350,20859,26200,26763,21521
2013,"...Miscellaneous entertainment attendants and related workers",47151,26402,20749,25143,25928,24154
2013,"...Couriers and messengers",151599,130948,20651,37808,39789,30480
2013,"Environmental scientists and geoscientists",65341,45052,20289,71065,77333,61583
2013,"...Computer, automated teller, and office machine repairers",176644,156442,20202,42430,43137,39601
2013,"...Counter attendants, cafeteria, food concession, and coffee shop",30891,10920,19971,17544,20304,16771
2013,"...First-line supervisors of protective service workers, all other",73041,53093,19948,47876,50239,44965
2013,"...Procurement clerks",32617,13441,19176,50876,65297,45564
2013,"...Veterinary assistants and laboratory animal caretakers",23366,4416,18950,22858,26551,22461
2013,"Archivists, curators, and museum technicians",31925,13316,18609,51704,58285,46130
2013,"Directors, religious activities and education",34970,16961,18009,40736,43053,38681
2013,"...Maintenance and repair workers, general",449977,432709,17268,41557,41683,36185
2013,"...First-line supervisors of mechanics, installers, and repairers",243639,226658,16981,56777,57076,52927
2013,"...First-line supervisors of construction trades and extraction workers",601644,584749,16895,55843,56164,43878
2013,"Chemical technicians",51689,34926,16763,50982,51831,47360
2013,"...Painters, construction and maintenance",326717,310089,16628,30027,30131,26453
2013,"Electrical and electronics engineers",180122,163656,16466,91895,93351,81167
2013,"...Pharmacy aides",22034,5644,16390,29851,30645,29383
2013,"...Switchboard operators, including answering service",20377,4152,16225,25878,33816,23936
2013,"Miscellaneous social scientists and related workers, including sociologists",32080,15884,16196,59540,68632,52123
2013,"...Dishwashers",102959,86995,15964,17307,17302,17332
2013,"....Postmasters and mail superintendents",28282,12394,15888,65191,77465,56317
2013,"...Pressers, textile, garment, and related materials",25595,10309,15286,21701,27268,20168
2013,"Statisticians",31319,16117,15202,81209,87488,74291
2013,"...First-line supervisors of police and detectives",102581,87467,15114,73155,75566,65227
2013,"...Residential advisors",24461,9448,15013,26098,27339,25074
2013,"...Lifeguards and other recreational, and all other protective service workers",32041,17049,14992,30781,32037,27889
2013,"...Personal care and service workers, all other",48690,33740,14950,25529,26597,21820
2013,"...First-line supervisors of correctional officers",49105,34261,14844,49986,54853,44324
2013,"...Animal trainers",27354,12684,14670,27188,29644,26400
2013,"Mechanical engineers",206515,191858,14657,79565,80193,72416
2013,"Cost estimators",105744,91484,14260,57333,60249,49443
2013,"...Cutting, punching, and press machine setters, operators, and tenders, metal and plastic",75234,61087,14147,31664,32671,26923
2013,"...Machinists",330090,316382,13708,45163,45549,31887
2013,"...Radio and telecommunications equipment installers and repairers",142862,129293,13569,52061,52209,45468
2013,"...Nurse anesthetists",21664,8259,13405,147152,150870,142185
2013,"Credit analysts",23011,9607,13404,53869,56903,51602
2013,"...Baggage porters, bellhops, and concierges",59390,46419,12971,31416,31799,30572
2013,"Library technicians",16163,3583,12580,31698,38063,31014
2013,"...Automotive and watercraft service attendants",67748,55406,12342,22312,22729,20516
2013,"Musicians, singers, and related workers",60370,48227,12143,42746,42988,42279
2013,"Aerospace engineers",117942,105914,12028,100701,101260,90023
2013,"....Architectural and engineering managers",132575,120777,11798,121336,121690,113507
2013,"...Office machine operators, except computer",24326,12575,11751,32321,35302,31192
2013,"...Photographic process workers and processing machine operators",25840,14124,11716,26166,31888,21348
2013,"....Compensation and benefits managers",14656,3387,11269,71927,97552,68207
2013,"...Statistical assistants",17346,6145,11201,41311,46090,40058
2013,"...Barbers",68648,57663,10985,21874,22321,18509
2013,"Agents and business managers of artists, performers, and athletes",28413,17494,10919,51244,51910,47043
2013,"...Prepress technicians and workers",23527,12712,10815,32464,38946,28806
2013,"...Carpenters",677720,667276,10444,34496,34698,26702
2013,"...Painting workers",101860,91461,10399,32285,33422,28032
2013,"...Firefighters",256196,246017,10179,62189,62361,57346
2013,"Information security analysts",50853,40681,10172,84140,86349,80245
2013,"...New accounts clerks",13217,3094,10123,34776,47191,31894
2013,"...Electricians",583544,573504,10040,49969,50029,41299
2013,"...Cutting workers",49849,40036,9813,29415,31113,21516
2013,"...Industrial and refractory machinery mechanics",332142,322465,9677,50350,50482,41142
2013,"...Optometrists",25610,16298,9312,103805,120521,96186
2013,"...Parts salespersons",82536,73360,9176,33375,34231,27467
2013,"...Other installation, maintenance, and repair workers, including wind turbine service technicians",168658,159562,9096,36654,37008,28922
2013,"Agricultural and food science technicians",24559,15509,9050,42576,45910,39464
2013,"...Radiation therapists",14694,5731,8963,75639,84219,68886
2013,"...Occupational therapy assistants and aides",10875,1945,8930,48814,50311,48606
2013,"...Automotive service technicians and mechanics",681551,672920,8631,35491,35523,31587
2013,"....Natural sciences managers",16766,8633,8133,94448,121164,85416
2013,"...Jewelers and precious stone and metal workers",26929,18880,8049,33334,36494,24657
2013,"...Audiologists",10771,3078,7693,76440,82289,75339
2013,"...Transportation security screeners",21025,13467,7558,41104,40732,41751
2013,"Computer network architects",91709,84233,7476,96372,96549,94445
2013,"Chemical engineers",53119,45725,7394,100231,100632,95507
2013,"...Models, demonstrators, and product promoters",12335,4971,7364,30930,50929,27018
2013,"...Chiropractors",34499,27139,7360,70513,72468,60223
2013,"...Crushing, grinding, polishing, mixing, and blending workers",70478,63515,6963,36849,37709,32032
2013,"Environmental engineers",25988,19105,6883,77406,80413,72478
2013,"...Aircraft mechanics and service technicians",141341,134480,6861,55948,56690,45440
2013,"...Machine feeders and offbearers",21230,14507,6723,25667,30290,21911
2013,"Computer hardware engineers",51453,44773,6680,91967,95258,76236
2013,"....Gaming managers",17294,10632,6662,51221,52127,47845
2013,"Actuaries",23200,16642,6558,112191,116019,106759
2013,"...Construction and building inspectors",67510,60968,6542,52318,53088,45705
2013,"...First-line supervisors of farming, fishing, and forestry workers",50720,44245,6475,38025,39581,31456
2013,"....Legislators",14815,8375,6440,67155,71530,65325
2013,"Surveyors, cartographers, and photogrammetrists",31315,24924,6391,59354,61190,50876
2013,"Agricultural and food scientists",22154,15764,6390,60826,62867,53805
2013,"Urban and regional planners",17145,10824,6321,67392,71693,62266
2013,"Judicial law clerks",11115,4920,6195,55545,54778,55883
2013,"Economists",20957,14810,6147,105834,120076,82427
2013,"...Tour and travel guides",15628,9572,6056,29404,29043,30413
2013,"...Health diagnosing and treating practitioners, all other",10251,4314,5937,48175,52729,42025
2013,"...Recreational therapists",9144,3265,5879,41923,42004,41782
2013,"...Air traffic controllers and airfield operations specialists",33382,27511,5871,77014,80236,65873
2013,"...Transportation attendants, except flight attendants",11113,5383,5730,30763,41630,22992
2013,"...Morticians, undertakers, and funeral directors",28279,22551,5728,47219,51129,31023
2013,"Miscellaneous media and communications equipment workers, including broadcast and sound engineering technicians and radio operators",68484,62777,5707,50514,50378,52954
2013,"...Refuse and recyclable material collectors",73441,67859,5582,29333,30057,22209
2013,"...Molders and molding machine setters, operators, and tenders, metal and plastic",35447,29875,5572,36377,38294,30011
2013,"...Telecommunications line installers and repairers",118663,113126,5537,48906,47527,55989
2013,"...Textile winding, twisting, and drawing out machine setters, operators, and tenders",9594,4129,5465,25266,24567,25449
2013,"...Paper goods machine setters, operators, and tenders",26459,21034,5425,39446,45905,25134
2013,"Financial examiners",10413,5134,5279,71779,77263,60411
2013,"...Grinding, lapping, polishing, and buffing machine tool setters, operators, and tenders, metal and plastic",38305,33030,5275,31843,32823,25041
2013,"...Computer control programmers and operators",72368,67129,5239,41755,42021,36468
2013,"...Cargo and freight agents",16189,10989,5200,42040,42852,40984
2013,"Biological technicians",13985,8785,5200,45798,46823,41644
2013,"...Pipelayers, plumbers, pipefitters, and steamfitters",397714,392587,5127,43340,43411,41047
2013,"...Chemical processing machine setters, operators, and tenders",49659,44589,5070,50608,51669,38087
2013,"Announcers",25670,20703,4967,40913,40829,41437
2013,"Entertainers and performers, sports and related workers, all other",14230,9381,4849,40633,42245,32475
2013,"...Transportation inspectors",35783,30980,4803,55959,58158,45220
2013,"...Extruding, forming, pressing, and compacting machine setters, operators, and tenders",21803,17029,4774,34475,36743,24444
2013,"Geological and petroleum technicians",16156,11467,4689,61110,62243,52394
2013,"...Agricultural inspectors",12458,7808,4650,45328,46125,44682
2013,"...First-line supervisors of landscaping, lawn service, and groundskeeping workers",112776,108132,4644,38990,39564,31980
2013,"Surveying and mapping technicians",45449,40811,4638,48685,49813,42403
2013,"Materials engineers",27975,23360,4615,80011,80877,73038
2013,"...Brokerage clerks",5857,1328,4529,46129,50040,45834
2013,"Conservation scientists and foresters",20271,15850,4421,56075,58798,52387
2013,"...Miscellaneous textile, apparel, and furnishings workers, including extruding and forming machine setters, operators, and tenders, synthetic and glass fibers",10790,6417,4373,24685,28326,22354
2013,"...Precision instrument and equipment repairers",53885,49578,4307,46805,47813,40064
2013,"...Operating engineers and other construction equipment operators, including pile-driver operators",247830,243586,4244,42200,42289,33641
2013,"...Crossing guards",8589,4388,4201,31094,31471,30767
2013,"Dancers and choreographers",5424,1239,4185,31678,50701,30782
2013,"...Woodworking machine setters, operators, and tenders, except sawing",20413,16259,4154,26115,26282,25489
2013,"...Helpers--production workers",25685,21637,4048,26744,27179,22732
2013,"Actors",12456,8445,4011,40438,40745,37149
2013,"...Upholsterers",24713,20708,4005,29397,30724,20834
2013,"...Aircraft pilots and flight engineers",88969,85054,3915,100595,101007,50770
2013,"...Textile knitting and weaving machine setters, operators, and tenders",6615,2746,3869,27247,30288,25110
2013,"...Hazardous materials removal workers",23261,19410,3851,39516,40284,31033
2013,"...Material moving workers, all other",33196,29364,3832,35847,36755,28267
2013,"...Sheet metal workers",96747,92933,3814,41924,42004,34016
2013,"...Gaming cage workers",6046,2239,3807,23656,21105,27810
2013,"Computer and information research scientists",12993,9222,3771,95918,100222,88006
2013,"...Adhesive bonding machine operators and tenders",8680,4930,3750,29066,33187,23833
2013,"...Parking lot attendants",38720,35027,3693,23270,23889,19536
2013,"...Proofreaders and copy markers",6416,2922,3494,33979,35766,32700
2013,"...Animal control workers",10552,7135,3417,35527,35656,32462
2013,"Television, video, and motion picture camera operators and editors",28620,25400,3220,50835,51081,42205
2013,"...Water and wastewater treatment plant and system operators",80472,77340,3132,45638,45724,41945
2013,"...Heating, air conditioning, and refrigeration mechanics and installers",279902,276780,3122,41810,41855,32257
2013,"...Coin, vending, and amusement machine servicers and repairers",26854,23787,3067,35333,35885,32002
2013,"...Ushers, lobby attendants, and ticket takers",5964,2920,3044,22057,29552,20904
2013,"...Meter readers, utilities",25811,22795,3016,36555,36161,43775
2013,"...Communications equipment operators, all other",6543,3590,2953,46847,53684,34538
2013,"...Railroad conductors and yardmasters",43061,40176,2885,65417,65462,65256
2013,"...Food preparation and serving related workers, all other",3940,1191,2749,18510,12147,20039
2013,"...Miscellaneous plant and system operators",37086,34414,2672,61601,62068,53601
2013,"...Molders, shapers, and casters, except metal and plastic",23056,20401,2655,30639,31191,20724
2013,"...Sales engineers",33279,30626,2653,93162,95047,77722
2013,"...Rolling machine setters, operators, and tenders, metal and plastic",9439,6791,2648,35348,39696,25227
2013,"Petroleum engineers",23225,20619,2606,110560,109564,120253
2013,"...Correspondence clerks",3933,1390,2543,31789,35020,31302
2013,"...Power plant operators, distributors, and dispatchers",44028,41680,2348,80959,81043,72351
2013,"...Fabric and apparel patternmakers",2639,296,2343,52694,53500,52582
2013,"...Heavy vehicle and mobile equipment service technicians and mechanics",178705,176382,2323,50242,50329,41656
2013,"...Motor vehicle operators, all other",16506,14232,2274,27418,30190,18932
2013,"...Parking enforcement workers",4876,2638,2238,36589,40588,32217
2013,"...Ambulance drivers and attendants, except emergency medical technicians",9147,6961,2186,24285,24657,22602
2013,"...Shoe machine operators and tenders",4373,2209,2164,21688,21536,21970
2013,"...First-line supervisors of fire fighting and prevention workers",47968,45815,2153,86462,87065,68891
2013,"...Stationary engineers and boiler operators",81858,79736,2122,55732,55864,54415
2013,"...Automotive body and related repairers",113922,111855,2067,38943,39370,31007
2013,"...Extruding and drawing machine setters, operators, and tenders, metal and plastic",10880,8824,2056,38438,40222,32041
2013,"...Embalmers and funeral attendants",6643,4600,2043,26042,27020,19780
2013,"...Mining machine operators",65476,63436,2040,65453,65606,57397
2013,"Atmospheric and space scientists",10661,8657,2004,69873,76668,56603
2013,"...Desktop publishers",3241,1249,1992,46502,51304,39944
2013,"...Locomotive engineers and operators",43391,41408,1983,77002,78762,55528
2013,"...Other transportation workers",16054,14073,1981,42418,42494,42068
2013,"...Bus and truck mechanics and diesel engine specialists",259470,257501,1969,42775,42902,36083
2013,"...Carpet, floor, and tile installers and finishers",94438,92480,1958,31025,31028,30093
2013,"...Pest control workers",53799,51894,1905,33351,33871,24899
2013,"...Forest and conservation workers",9161,7295,1866,31045,32118,24167
2013,"...Avionics technicians",17066,15218,1848,51056,51834,42398
2013,"...Crane and tower operators",52665,50867,1798,51507,51448,51941
2013,"Astronomers and physicists",9359,7563,1796,101983,100930,105332
2013,"...Highway maintenance workers",80392,78627,1765,37416,37480,31543
2013,"....Emergency management directors",6422,4662,1760,73381,73478,73102
2013,"...Food cooking machine operators and tenders",5670,3950,1720,27563,30554,22015
2013,"Miscellaneous mathematical science occupations",3686,1974,1712,70370,75221,56018
2013,"...Pumping station operators",25133,23425,1708,60787,60134,130660
2013,"...Food and tobacco roasting, baking, and drying machine operators and tenders",7085,5409,1676,32919,36385,26845
2013,"...Fire inspectors",16734,15065,1669,56114,55777,60478
2013,"...Furnace, kiln, oven, drier, and kettle operators and tenders",11333,9713,1620,35408,35876,24819
2013,"Biomedical engineers",12371,10765,1606,78629,77459,85248
2013,"...Podiatrists",6757,5184,1573,120367,126978,62064
2013,"...Furniture finishers",7639,6161,1478,30211,32936,26337
2013,"...Etchers and engravers",6620,5150,1470,31708,33319,24509
2013,"Social science research assistants",4333,2950,1383,40464,40888,35803
2013,"...Aircraft structure, surfaces, rigging, and systems assemblers",5202,3823,1379,47268,51161,35660
2013,"...Drywall installers, ceiling tile installers, and tapers",87974,86599,1375,29120,29122,27477
2013,"...Sawing machine setters, operators, and tenders, wood",22242,20877,1365,27395,27449,26034
2013,"...Tool and die makers",51409,50058,1351,54084,54642,36745
2013,"...Electronic home entertainment equipment installers and repairers",33927,32579,1348,41295,41385,30949
2013,"...Cabinetmakers and bench carpenters",38783,37474,1309,31379,31685,21543
2013,"Buyers and purchasing agents, farm products",7184,5882,1302,51036,51063,50742
2013,"...Electrical power-line installers and repairers",99444,98259,1185,70022,69852,80439
2013,"...Shoe and leather workers and repairers",6508,5326,1182,26334,28974,21262
2013,"...Model makers and patternmakers, metal and plastic",6061,4886,1175,42126,45087,36732
2013,"...Tire builders",14330,13161,1169,49825,50462,37200
2013,"...Textile cutting machine setters, operators, and tenders",4006,2842,1164,24492,26319,18793
2013,"...Miscellaneous woodworkers, including model makers and patternmakers",17735,16619,1116,31347,31991,18913
2013,"...Structural iron and steel workers",45516,44413,1103,45603,45617,41302
2013,"...Subway, streetcar, and other rail transportation workers",9669,8566,1103,59028,61243,55787
2013,"...Security and fire alarm systems installers",41748,40680,1068,42135,42157,41096
2013,"...Miscellaneous vehicle and mobile equipment mechanics, installers, and repairers",52737,51671,1066,27061,27158,23954
2013,"...Engine and other machine assemblers",10950,9903,1047,40939,41657,35316
2013,"...Explosives workers, ordnance handling experts, and blasters",10755,9710,1045,49568,50630,36960
2013,"...Plating and coating machine setters, operators, and tenders, metal and plastic",13378,12355,1023,34069,35031,26024
2013,"...Cleaning, washing, and metal pickling equipment operators and tenders",6098,5077,1021,31567,31884,26250
2013,"....Funeral service managers",5439,4421,1018,70805,71617,52125
2013,"...Lathe and turning machine tool setters, operators, and tenders, metal and plastic",8530,7524,1006,37227,39932,27079
2013,"...Metal furnace operators, tenders, pourers, and casters",18709,17712,997,45782,45644,48828
2013,"...Drilling and boring machine tool setters, operators, and tenders, metal and plastic",4002,3031,971,35366,36947,30941
2013,"...Helpers--installation, maintenance, and repair workers",14156,13193,963,27385,26932,29307
2013,"...Home appliance repairers",29444,28494,950,37293,37384,28702
2013,"...Control and valve installers and repairers",18621,17694,927,50254,50548,40393
2013,"...Hoist and winch operators",6973,6060,913,41722,46825,26862
2013,"...Electric motor, power tool, and related repairers",21134,20230,904,50157,50430,30066
2013,"...Logging workers",45150,44259,891,31072,31186,23640
2013,"...Automotive glass installers and repairers",14117,13237,880,36325,36293,37687
2013,"...Other extraction workers",55483,54614,869,51020,50962,59240
2013,"...Insulation workers",34531,33664,867,36618,36800,30763
2013,"Marine engineers and naval architects",11147,10288,859,81250,85451,70430
2013,"...Animal breeders",2642,1785,857,29195,30906,25666
2013,"...Miscellaneous construction and related workers, including solar photovoltaic installers",25828,24994,834,37308,38921,24550
2013,"...Locksmiths and safe repairers",17151,16358,793,37251,37993,24135
2013,"...Roofers",118795,118021,774,27499,27678,19114
2013,"...Semiconductor processors",1988,1233,755,39118,50057,31023
2013,"...Multiple machine tool setters, operators, and tenders, metal and plastic",2437,1767,670,46845,53347,26824
2013,"...Structural metal fabricators and fitters",20509,19856,653,40196,40346,30970
2013,"...Transit and railroad police",2623,1977,646,53590,55521,51100
2013,"...Brickmasons, blockmasons, and stonemasons",77234,76622,612,31967,32024,25210
2013,"Nuclear engineers",4813,4205,608,84017,86028,71482
2013,"...Conveyor operators and tenders",4831,4225,606,36041,36374,24934
2013,"...Fishing and hunting workers",21018,20416,602,33226,35018,24415
2013,"...Millwrights",37622,37034,588,60128,60153,56197
2013,"...Heat treating equipment setters, operators, and tenders, metal and plastic",6459,5874,585,40726,40662,46350
2013,"Mining and geological engineers, including mining safety engineers",8430,7886,544,87279,86617,108500
2013,"...Sailors and marine oilers",12690,12153,537,48856,49771,37716
2013,"...Bridge and lock tenders",3240,2712,528,45080,50039,27053
2013,"Agricultural engineers",2952,2425,527,70585,73207,39356
2013,"...Electrical and electronics repairers, industrial and utility",10426,9921,505,65252,65526,60320
2013,"...Ship and boat captains and operators",26328,25849,479,69566,70159,37067
2013,"Survey researchers",836,358,478,70521,117685,70443
2013,"...Electronic equipment installers and repairers, motor vehicles",8864,8405,459,40489,40818,22493
2013,"Nuclear technicians",3722,3265,457,100455,110076,71540
2013,"...Maintenance workers, machinery",23855,23410,445,45714,45579,57318
2013,"...Small engine mechanics",31008,30586,422,31387,31369,31591
2013,"...Textile bleaching and dyeing machine operators and tenders",1989,1587,402,30170,28612,31154
2013,"...Glaziers",30821,30444,377,35703,35881,20444
2013,"...Derrick, rotary drill, and service unit operators, oil, gas, and mining",29652,29284,368,67369,67593,31710
2013,"...Boilermakers",9092,8753,339,55887,56031,42065
2013,"Life scientists, all other",1043,706,337,61321,54143,70276
2013,"Mathematicians",1933,1603,330,79256,73799,99362
2013,"...Paperhangers",2232,1906,326,47083,50374,40361
2013,"...Dredge, excavating, and loading machine operators",26394,26074,320,41841,41892,28750
2013,"...Helpers, construction trades",23274,22956,318,27555,27431,34839
2013,"...Earth drillers, except oil and gas",22569,22278,291,52212,52060,62442
2013,"...Tool grinders, filers, and sharpeners",4643,4375,268,40022,40550,30966
2013,"...Elevator installers and repairers",20339,20077,262,85914,85807,87403
2013,"...Ship engineers",4145,3894,251,77584,78984,70984
2013,"...Milling and planing machine setters, operators, and tenders, metal and plastic",2780,2531,249,36621,36487,37304
2013,"...Forging machine setters, operators, and tenders, metal and plastic",6847,6616,231,40969,41164,26124
2013,"...Helpers--extraction workers",3690,3498,192,50147,49887,55662
2013,"...Layout workers, metal and plastic",6077,5911,166,47903,48655,41135
2013,"...Cooling and freezing equipment operators and tenders",2208,2062,146,35556,37889,21726
2013,"...Tank car, truck, and ship loaders",4741,4635,106,40401,40628,13806
2013,"...Fence erectors",17578,17480,98,30664,30669,16111
2013,"...Motion picture projectionists",2083,1989,94,31391,31291,100508
2014,"Chief executives",1013853,774838,239015,122136,130830,101174
2014,"....General and operations managers",761445,545655,215790,67100,74888,53539
2014,"....Legislators",14365,8413,5952,71632,76794,70059
2014,"....Advertising and promotions managers",44209,20591,23618,61097,75638,52378
2014,"....Marketing and sales managers",760335,434308,326027,80973,97067,65229
2014,"....Public relations and fundraising managers",50604,17962,32642,76796,91993,70227
2014,"....Administrative services managers",122275,78429,43846,64620,71025,54308
2014,"....Computer and information systems managers",501450,364546,136904,100247,101957,88946
2014,"....Financial managers",1015563,485108,530455,72464,94742,60512
2014,"....Compensation and benefits managers",13138,2824,10314,80417,116768,75904
2014,"....Human resources managers",332171,131578,200593,70814,77259,66608
2014,"....Training and development managers",42441,21790,20651,75739,81439,69605
2014,"....Industrial production managers",222929,178832,44097,74546,76623,65474
2014,"....Purchasing managers",174227,94380,79847,74537,81163,65221
2014,"....Transportation, storage, and distribution managers",197645,162291,35354,51790,51532,55211
2014,"....Farmers, ranchers, and other agricultural managers",476355,428794,47561,41416,41984,30726
2014,"....Construction managers",491817,460265,31552,70037,70391,60483
2014,"....Education administrators",722529,262082,460447,68868,79569,62001
2014,"....Architectural and engineering managers",139986,127411,12575,124703,125512,120158
2014,"....Food service managers",775402,423081,352321,36471,41587,31092
2014,"....Funeral service managers",5982,4638,1344,62196,61996,70489
2014,"....Gaming managers",14326,9074,5252,53478,55969,50369
2014,"....Lodging managers",99057,51022,48035,43446,50487,39723
2014,"....Medical and health services managers",564606,168025,396581,71440,85292,66115
2014,"....Natural sciences managers",15569,8745,6824,80292,101115,71535
2014,"....Postmasters and mail superintendents",24028,10550,13478,69105,75273,63780
2014,"....Property, real estate, and community association managers",436425,214284,222141,50395,60819,44159
2014,"....Social and community service managers",281769,93870,187899,53263,60158,51343
2014,"....Emergency management directors",6951,5457,1494,68901,68843,72877
2014,"....Managers, all other",3571939,2379728,1192211,75766,81484,63700
2014,"...Business and Financial Operations Occupations:",5809077,2672417,3136660,60934,70728,54018
2014,"Agents and business managers of artists, performers, and athletes",27459,15621,11838,54283,60818,50170
2014,"Buyers and purchasing agents, farm products",7705,5892,1813,44818,50060,37830
2014,"Wholesale and retail buyers, except farm products",136489,67668,68821,42159,42033,42271
2014,"Purchasing agents, except wholesale, retail, and farm products",251774,123335,128439,52529,58713,49852
2014,"Claims adjusters, appraisers, examiners, and investigators",267839,109789,158050,51001,57748,46759
2014,"Compliance officers",188361,91085,97276,65105,70067,61418
2014,"Cost estimators",115808,103325,12483,61037,61776,50332
2014,"Human resources workers",625092,172605,452487,54089,62362,51655
2014,"Compensation, benefits, and job analysis specialists",42428,8853,33575,50075,62739,47450
2014,"Training and development specialists",104051,43450,60601,54215,61958,49533
2014,"Logisticians",100957,63832,37125,51574,54775,47353
2014,"Management analysts",587570,344850,242720,80535,89368,72260
2014,"Meeting, convention, and event planners",82089,20356,61733,47698,50086,47205
2014,"Fundraisers",70528,20451,50077,60078,63150,57571
2014,"Market research analysts and marketing specialists",230827,102742,128085,66945,79902,60798
2014,"Business operations specialists, all other",234988,105222,129766,57650,66402,51754
2014,"Accountants and auditors",1562860,641601,921259,60970,71611,54676
2014,"Appraisers and assessors of real estate",69205,48033,21172,52387,60032,45696
2014,"Budget analysts",42931,15702,27229,73617,81622,67367
2014,"Credit analysts",26676,12241,14435,51701,56119,47764
2014,"Financial analysts",180971,107860,73111,78843,84758,73685
2014,"Personal financial advisors",312232,216545,95687,83154,100564,63432
2014,"Insurance underwriters",99576,32369,67207,59253,71090,55763
2014,"Financial examiners",11708,6213,5495,80648,91839,66456
2014,"Credit counselors and loan officers",270825,123437,147388,55515,71012,46834
2014,"Tax examiners and collectors, and revenue agents",50454,18782,31672,51944,63606,47747
2014,"Tax preparers",52982,24476,28506,52451,56832,50927
2014,"Financial specialists, all other",54692,26082,28610,61982,91705,49220
2014,"..Computer, Engineering, and Science Occupations:",6853148,5216177,1636971,76036,79847,66500
2014,"...Computer and mathematical occupations:",3556981,2670024,886957,77975,81043,70786
2014,"Computer and information research scientists",13529,11168,2361,102201,103624,91426
2014,"Computer systems analysts",473960,302291,171669,76506,81294,69406
2014,"Information security analysts",53003,42352,10651,86632,90671,75779
2014,"Computer programmers",374346,297722,76624,81928,82951,77830
2014,"Software developers, applications and systems software",979815,792074,187741,95739,99519,85287
2014,"Web developers",145465,97577,47888,61023,65007,53650
2014,"Computer support specialists",470915,349868,121047,52551,53807,50956
2014,"Database administrators",102296,65627,36669,77455,86854,56890
2014,"Network and computer systems administrators",183110,150346,32764,69647,70533,64094
2014,"Computer network architects",97510,88248,9262,92623,94255,86560
2014,"Computer occupations, all other",476615,368819,107796,68159,68787,67019
2014,"Actuaries",26071,16914,9157,101355,105153,100158
2014,"Mathematicians",2335,1760,575,108154,120660,55489
2014,"Operations research analysts",122903,66552,56351,77416,82373,71696
2014,"Statisticians",32115,17054,15061,83461,87419,80913
2014,"Miscellaneous mathematical science occupations",2993,1652,1341,71689,75217,67183
2014,"...Architecture and Engineering Occupations:",2306736,1984905,321831,77429,80191,66818
2014,"Architects, except naval",141773,109020,32753,74630,79542,63215
2014,"Surveyors, cartographers, and photogrammetrists",30688,25077,5611,57018,57296,54594
2014,"Aerospace engineers",108106,94450,13656,100551,101474,85045
2014,"Agricultural engineers",2275,2129,146,77830,77894,77703
2014,"Biomedical engineers",12151,10045,2106,85212,90275,74343
2014,"Chemical engineers",50207,42425,7782,98259,100275,87309
2014,"Civil engineers",263869,231947,31922,81639,82405,72899
2014,"Computer hardware engineers",48738,40015,8723,92845,98302,85309
2014,"Electrical and electronics engineers",189028,172016,17012,92224,93711,82691
2014,"Environmental engineers",23435,17469,5966,83190,85840,80798
2014,"Industrial engineers, including health and safety",160051,130663,29388,78029,79476,72469
2014,"Marine engineers and naval architects",11931,10759,1172,79677,80931,62262
2014,"Materials engineers",29248,26574,2674,78907,79129,73533
2014,"Mechanical engineers",220593,204412,16181,80674,80890,76532
2014,"Mining and geological engineers, including mining safety engineers",10735,9876,859,101450,101177,104954
2014,"Nuclear engineers",5689,5178,511,100588,100899,100345
2014,"Petroleum engineers",26436,24334,2102,119645,120198,108664
2014,"Engineers, all other",446166,389678,56488,90963,91811,80959
2014,"Drafters",124795,102986,21809,51324,52440,43037
2014,"Engineering technicians, except drafters",344546,284353,60193,52925,55961,41755
2014,"Surveying and mapping technicians",56276,51499,4777,50838,51271,41269
2014,"...Life, Physical, and Social Science Occupations:",989431,561248,428183,61920,66545,57875
2014,"Agricultural and food scientists",17148,11511,5637,63076,66204,56742
2014,"Biological scientists",57529,29504,28025,62045,62296,61723
2014,"Conservation scientists and foresters",15754,12073,3681,56746,56925,55702
2014,"Medical scientists",114987,55413,59574,71874,79409,70170
2014,"Life scientists, all other",5315,3208,2107,76852,77448,75448
2014,"Astronomers and physicists",8487,7212,1275,100557,100878,74550
2014,"Atmospheric and space scientists",8973,7438,1535,84118,84922,80803
2014,"Chemists and materials scientists",75390,48305,27085,68111,71203,64146
2014,"Environmental scientists and geoscientists",61131,43304,17827,74949,80066,64967
2014,"Physical scientists, all other",171195,102042,69153,72973,81838,62530
2014,"Economists",19978,13224,6754,110548,120249,97869
2014,"Survey researchers",947,338,609,47236,95694,45808
2014,"Psychologists",115413,38825,76588,70415,82152,63914
2014,"Urban and regional planners",19217,11650,7567,71496,76563,58594
2014,"Miscellaneous social scientists and related workers, including sociologists",37644,18711,18933,53839,59402,49466
2014,"Agricultural and food science technicians",30884,20341,10543,45171,45592,43189
2014,"Biological technicians",18297,10874,7423,47322,51206,43010
2014,"Chemical technicians",59973,40817,19156,51100,55310,46166
2014,"Geological and petroleum technicians",11704,9491,2213,61113,61552,58773
2014,"Nuclear technicians",3322,2899,423,81607,81518,120118
2014,"Social science research assistants",1666,582,1084,41279,62318,33376
2014,"Miscellaneous life, physical, and social science technicians",134477,73486,60991,42097,45391,40335
2014,"..Education, Legal, Community Service, Arts, and Media Occupations:",10164825,3895376,6269449,50057,57516,45789
2014,"...Community and Social Service Occupations:",1872494,702106,1170388,42238,44335,41657
2014,"Counselors",499447,151784,347663,43086,42943,43144
2014,"Social workers",662207,133598,528609,42403,44262,42201
2014,"Probation officers and correctional treatment specialists",85020,38805,46215,47695,48441,46867
2014,"Social and human service assistants",132261,29857,102404,35827,39091,35331
2014,"Miscellaneous community and social service specialists, including health educators and community health workers",72471,25385,47086,40924,45046,39779
2014,"Clergy",334788,281877,52911,43671,45100,39185
2014,"Directors, religious activities and education",45159,21875,23284,41937,46639,40026
2014,"Religious workers, all other",41141,18925,22216,35801,36993,35353
2014,"...Legal Occupations:",1364082,687842,676240,85320,120569,62167
2014,"Lawyers",861223,575443,285780,120885,130819,101219
2014,"Judicial law clerks",11531,3470,8061,61117,61812,60639
2014,"Judges, magistrates, and other judicial workers",54753,30616,24137,96222,111928,80325
2014,"Paralegals and legal assistants",306773,43126,263647,46642,49289,46319
2014,"Miscellaneous legal support workers",129802,35187,94615,50929,64394,47439
2014,"...Education, Training, and Library Occupations:",5211831,1513551,3698280,48026,55730,45162
2014,"Postsecondary teachers",848073,446709,401364,65698,71982,60502
2014,"Preschool and kindergarten teachers",332062,8003,324059,24489,28156,24377
2014,"Elementary and middle school teachers",2315762,515461,1800301,49832,52275,48594
2014,"Secondary school teachers",535253,231738,303515,51547,53429,50548
2014,"Special education teachers",172214,24672,147542,46416,49768,45952
2014,"Other teachers and instructors",362242,170986,191256,45216,52063,38612
2014,"Archivists, curators, and museum technicians",30249,12270,17979,49160,56860,45282
2014,"Librarians",114109,20872,93237,49697,52528,48589
2014,"Library technicians",12623,3237,9386,31038,36862,28121
2014,"Teacher assistants",411405,57182,354223,21634,28311,20985
2014,"Other education, training, and library workers",77839,22421,55418,52058,57321,50771
2014,"...Arts, Design, Entertainment, Sports, and Media Occupations:",1716418,991877,724541,51028,54084,46698
2014,"Artists and related workers",114321,73161,41160,46646,51814,40191
2014,"Designers",574431,304311,270120,50005,55533,42444
2014,"Actors",10606,6414,4192,41569,46615,38251
2014,"Producers and directors",109665,69950,39715,63063,64642,61825
2014,"Athletes, coaches, umpires, and related workers",123608,93262,30346,42873,46140,38242
2014,"Dancers and choreographers",8058,1753,6305,30666,36905,27268
2014,"Musicians, singers, and related workers",64044,49552,14492,43538,42472,45683
2014,"Entertainers and performers, sports and related workers, all other",18169,11135,7034,37299,40847,34944
2014,"Announcers",23223,18830,4393,45303,45065,46654
2014,"News analysts, reporters and correspondents",58796,35832,22964,53751,57304,50461
2014,"Public relations specialists",98358,35621,62737,64970,76940,60011
2014,"Editors",121275,61510,59765,53892,57804,51764
2014,"Technical writers",47369,19623,27746,66590,69872,64769
2014,"Writers and authors",126601,60839,65762,58150,62207,52479
2014,"Miscellaneous media and communication workers",44430,15931,28499,40861,47478,36853
2014,"Miscellaneous media and communications equipment workers, including broadcast and sound engineering technicians and radio operators",68024,62903,5121,51725,52122,45207
2014,"Photographers",77681,46986,30695,37530,40650,35015
2014,"Television, video, and motion picture camera operators and editors",27759,24264,3495,50147,51223,37703
2014,"..Healthcare Practitioners and Technical Occupations:",6183734,1732770,4450964,60631,77993,56151
2014,"...Chiropractors",39109,28680,10429,71112,72458,60296
2014,"...Dentists",103211,78254,24957,150041,151764,121953
2014,"...Dietitians and nutritionists",66139,10548,55591,47909,46015,48645
2014,"...Optometrists",27120,16955,10165,101931,120535,91378
2014,"...Pharmacists",210328,101904,108424,116276,120410,112232
2014,"...Physicians and surgeons",686827,461288,225539,194521,211526,150053
2014,"...Physician assistants",75160,25626,49534,94513,102354,91296
2014,"...Podiatrists",6580,5080,1500,102486,135579,99821
2014,"...Audiologists",10476,2570,7906,72709,71475,73235
2014,"...Occupational therapists",62781,9027,53754,68823,75237,66990
2014,"...Physical therapists",154006,57984,96022,74449,80327,71083
2014,"...Radiation therapists",13222,3798,9424,75447,85545,72210
2014,"...Recreational therapists",7545,1976,5569,46466,51778,42049
2014,"...Respiratory therapists",89483,33330,56153,55979,60952,52433
2014,"...Speech-language pathologists",85021,4434,80587,62054,71703,61827
2014,"...Miscellaneous therapists, including exercise physiologists",99395,27919,71476,46527,50453,45564
2014,"...Veterinarians",62082,28586,33496,87898,100638,80243
2014,"...Registered nurses",2183447,253618,1929829,62280,67965,61961
2014,"...Nurse anesthetists",20026,8875,11151,150828,162997,142372
2014,"...Nurse practitioners",92649,10063,82586,93344,100765,92421
2014,"...Health diagnosing and treating practitioners, all other",12639,4201,8438,45654,52089,42772
2014,"...Clinical laboratory technologists and technicians",240655,67742,172913,46116,50251,45086
2014,"...Dental hygienists",62115,4690,57425,57014,90873,56113
2014,"...Diagnostic related technologists and technicians",243730,77199,166531,55288,61101,52395
2014,"...Emergency medical technicians and paramedics",161288,116818,44470,42006,45812,36003
2014,"...Health practitioner support technologists and technicians",431165,109040,322125,34036,43170,31930
2014,"...Licensed practical and licensed vocational nurses",588550,73173,515377,37020,39777,36863
2014,"...Medical records and health information technicians",128111,12214,115897,35805,37349,35578
2014,"...Opticians, dispensing",42394,13631,28763,37327,45916,34290
2014,"...Miscellaneous health technologists and technicians",97285,40613,56672,40935,46835,37369
2014,"...Other healthcare practitioners and technical occupations",76705,42934,33771,51767,55296,47198
2014,"..Healthcare Support Occupations:",2098584,290377,1808207,27174,30526,26894
2014,"...Nursing, psychiatric, and home health aides",1204676,163850,1040826,25613,27354,25353
2014,"...Occupational therapy assistants and aides",12056,839,11217,46812,48175,46725
2014,"...Physical therapist assistants and aides",49661,14590,35071,45272,47565,44280
2014,"...Massage therapists",59445,15114,44331,29167,30553,28603
2014,"...Dental assistants",160356,12214,148142,31154,38150,30934
2014,"...Medical assistants",371596,33230,338366,29161,32055,28834
2014,"...Medical transcriptionists",27861,1643,26218,31621,36889,31436
2014,"...Pharmacy aides",27555,5863,21692,30371,35713,29246
2014,"...Veterinary assistants and laboratory animal caretakers",25916,4685,21231,26224,31865,25464
2014,"...Phlebotomists",71105,8742,62363,30387,32364,30164
2014,"...Healthcare support workers, all other, including medical equipment preparers",88357,29607,58750,28572,33008,26809
2014,"..Protective Service Occupations:",2582882,2092393,490489,49555,51369,40422
2014,"...First-line supervisors of correctional officers",54772,39920,14852,51123,52747,47980
2014,"...First-line supervisors of police and detectives",99163,83876,15287,76115,79451,59909
2014,"...First-line supervisors of fire fighting and prevention workers",39947,38140,1807,84250,85472,70432
2014,"...First-line supervisors of protective service workers, all other",67352,49211,18141,50683,51016,49734
2014,"...Firefighters",278058,269060,8998,65037,65166,55953
2014,"...Fire inspectors",15969,14224,1745,56286,56968,48737
2014,"...Bailiffs, correctional officers, and jailers",396206,291867,104339,43548,46662,38324
2014,"...Detectives and criminal investigators",122800,93314,29486,74362,80236,60317
2014,"...Fish and game wardens",5090,4535,555,50428,49161,58450
2014,"...Parking enforcement workers",5647,3430,2217,40090,40887,35148
2014,"...Police and sheriff's patrol officers",679836,589160,90676,60535,61068,52937
2014,"...Transit and railroad police",1549,1296,253,61442,61917,47964
2014,"...Animal control workers",8844,5007,3837,33046,34706,30741
2014,"...Private detectives and investigators",74485,42162,32323,51775,57338,45554
2014,"...Security guards and gaming surveillance officers",672682,528648,144034,30461,30625,29526
2014,"...Crossing guards",11937,6732,5205,31936,30186,36788
2014,"...Transportation security screeners",22644,14885,7759,40748,41780,38436
2014,"...Lifeguards and other recreational, and all other protective service workers",25901,16926,8975,30550,33579,24645
2014,"..Food Preparation and Serving Related Occupations:",3563188,1931113,1632075,21513,22709,20202
2014,"...Chefs and head cooks",317690,258841,58849,30912,31333,27334
2014,"...First-line supervisors of food preparation and serving workers",361486,164698,196788,24662,27882,21967
2014,"...Cooks",1158633,748984,409649,20695,21436,18708
2014,"...Food preparation workers",312134,147221,164913,19113,20107,18110
2014,"...Bartenders",206547,98170,108377,26711,30599,24184
2014,"...Combined food preparation and serving workers, including fast food",127802,45650,82152,19301,19509,19204
2014,"...Counter attendants, cafeteria, food concession, and coffee shop",32166,11409,20757,17266,18258,16890
2014,"...Waiters and waitresses",701881,255486,446395,21238,23875,20133
2014,"...Food servers, nonrestaurant",82495,30421,52074,23645,27673,21543
2014,"...Dining room and cafeteria attendants and bartender helpers",106948,69856,37092,20330,20922,18970
2014,"...Dishwashers",108067,89294,18773,17764,17900,17295
2014,"...Hosts and hostesses, restaurant, lounge, and coffee shop",40718,7322,33396,18456,25206,17163
2014,"...Food preparation and serving related workers, all other",6621,3761,2860,18287,17877,18413
2014,"..Building and Grounds Cleaning and Maintenance Occupations:",3385523,2270153,1115370,25507,28153,20931
2014,"...First-line supervisors of housekeeping and janitorial workers",175328,115757,59571,36071,41271,27272
2014,"...First-line supervisors of landscaping, lawn service, and groundskeeping workers",113497,107925,5572,40065,40374,30951
2014,"...Janitors and building cleaners",1532714,1156110,376604,26883,29635,21904
2014,"...Maids and housekeeping cleaners",757647,119135,638512,20477,25146,19764
2014,"...Pest control workers",58844,55812,3032,35558,35499,36296
2014,"...Grounds maintenance workers",747493,715414,32079,24570,24616,22929
2014,"..Personal Care and Service Occupations:",2540749,630759,1909990,23718,29685,22201
2014,"...First-line supervisors of gaming workers",18128,11231,6897,44452,45984,40514
2014,"...First-line supervisors of personal service workers",60234,23389,36845,32818,36619,31367
2014,"...Animal trainers",27257,12136,15121,29592,35604,25656
2014,"...Nonfarm animal caretakers",106483,30268,76215,23806,26048,22859
2014,"...Gaming services workers",66084,38049,28035,38759,40433,36969
2014,"...Ushers, lobby attendants, and ticket takers",6175,3936,2239,25024,26850,23288
2014,"...Miscellaneous entertainment attendants and related workers",52296,30640,21656,25353,26824,23395
2014,"...Embalmers and funeral attendants",5333,4091,1242,32270,35674,25977
2014,"...Morticians, undertakers, and funeral directors",32853,24345,8508,50136,51651,39199
2014,"...Barbers",69049,56626,12423,25380,26015,22291
2014,"...Hairdressers, hairstylists, and cosmetologists",425183,46421,378762,24776,31715,23714
2014,"...Miscellaneous personal appearance workers",179507,35665,143842,21574,21809,21506
2014,"...Baggage porters, bellhops, and concierges",58485,47332,11153,30649,31464,28102
2014,"...Tour and travel guides",15875,10345,5530,27641,26595,30540
2014,"...Childcare workers",538900,29136,509764,20642,24602,20452
2014,"...Personal care aides",629543,115059,514484,21825,24091,21459
2014,"...Recreation and fitness workers",173857,73410,100447,31005,35635,27867
2014,"...Residential advisors",27719,9506,18213,27733,27532,27761
2014,"...Personal care and service workers, all other",46143,27591,18552,25728,26138,24444
2014,"..Sales and Related Occupations:",9834140,5788675,4045465,41747,50567,32122
2014,"...First-line supervisors of retail sales workers",2548184,1454977,1093207,38807,44447,32093
2014,"...First-line supervisors of non-retail sales workers",1073544,763485,310059,61010,62257,55013
2014,"...Cashiers",964264,275605,688659,20251,21696,19688
2014,"...Counter and rental clerks",47070,25390,21680,28446,36039,23941
2014,"...Parts salespersons",84821,75787,9034,35264,36195,26989
2014,"...Retail salespersons",1706417,1034865,671552,31567,36903,26051
2014,"...Advertising sales agents",139398,72167,67231,55768,60973,50664
2014,"...Insurance sales agents",435197,232437,202760,50441,61939,40861
2014,"...Securities, commodities, and financial services sales agents",212151,151873,60278,81020,100017,57024
2014,"...Travel agents",53306,10988,42318,39306,42195,37187
2014,"...Sales representatives, services, all other",529277,363958,165319,60973,66103,50916
2014,"...Sales representatives, wholesale and manufacturing",1177413,872483,304930,61920,65198,52549
2014,"...Models, demonstrators, and product promoters",15243,7024,8219,37469,36869,39774
2014,"...Real estate brokers and sales agents",534320,261734,272586,52124,62132,46221
2014,"...Sales engineers",32909,30615,2294,97271,98568,80547
2014,"...Telemarketers",38731,15021,23710,25063,27405,22793
2014,"...Door-to-door sales workers, news and street vendors, and related workers",54795,32505,22290,27326,29807,24704
2014,"...Sales and related workers, all other",187100,107761,79339,51804,60938,44199
2014,"..Office and Administrative Support Occupations:",13145902,3772191,9373711,35365,38667,34069
2014,"...First-line supervisors of office and administrative support workers",1146803,449090,697713,47166,52192,44181
2014,"...Switchboard operators, including answering service",18557,3038,15519,26952,27978,26883
2014,"...Telephone operators",28220,5516,22704,30644,35392,29157
2014,"...Communications equipment operators, all other",8194,4926,3268,50845,52307,34015
2014,"...Bill and account collectors",141345,39750,101595,33001,35614,32404
2014,"...Billing and posting clerks",375964,43730,332234,33078,38530,32379
2014,"...Bookkeeping, accounting, and auditing clerks",821268,111395,709873,37260,41368,36891
2014,"...Gaming cage workers",6326,2076,4250,27460,34971,26384
2014,"...Payroll and timekeeping clerks",124952,16181,108771,40093,41891,39584
2014,"...Procurement clerks",26885,11186,15699,49515,59765,43055
2014,"...Tellers",228539,33332,195207,25876,26341,25808
2014,"...Financial clerks, all other",94393,34648,59745,46241,66189,40423
2014,"...Brokerage clerks",6566,1547,5019,44597,54420,42373
2014,"...Correspondence clerks",4237,965,3272,35930,35075,36071
2014,"...Court, municipal, and license clerks",59598,13619,45979,36682,41381,35895
2014,"...Credit authorizers, checkers, and clerks",38097,10010,28087,37407,46838,36218
2014,"...Customer service representatives",1669991,591258,1078733,32332,36341,31531
2014,"...Eligibility interviewers, government programs",65854,12952,52902,41195,47051,40508
2014,"...File clerks",164174,37427,126747,31981,36499,31482
2014,"...Hotel, motel, and resort desk clerks",75704,29858,45846,21651,22119,21218
2014,"...Interviewers, except eligibility and loan",84111,15614,68497,32072,36282,31690
2014,"...Library assistants, clerical",34487,6071,28416,30596,33851,30195
2014,"...Loan interviewers and clerks",99022,19370,79652,41743,44236,41251
2014,"...New accounts clerks",12498,3866,8632,36786,40891,35459
2014,"...Order clerks",85608,38120,47488,31715,32151,31320
2014,"...Human resources assistants, except payroll and timekeeping",48476,9353,39123,38134,41918,37139
2014,"...Receptionists and information clerks",643687,61685,582002,27125,30650,26976
2014,"...Reservation and transportation ticket agents and travel clerks",87092,37127,49965,37781,41676,35527
2014,"...Information and record clerks, all other",73262,13687,59575,36034,40504,35578
2014,"...Cargo and freight agents",15275,9758,5517,40517,41102,40026
2014,"...Couriers and messengers",146362,128267,18095,39451,40454,35553
2014,"...Dispatchers",244363,107528,136835,37688,42178,34728
2014,"...Meter readers, utilities",25329,21464,3865,37039,36727,38729
2014,"...Postal service clerks",90764,46025,44739,54650,55978,52953
2014,"...Postal service mail carriers",252571,160610,91961,55921,57131,52261
2014,"...Postal service mail sorters, processors, and processing machine operators",52498,28102,24396,54788,55844,52804
2014,"...Production, planning, and expediting clerks",264366,118215,146151,44413,54623,38292
2014,"...Shipping, receiving, and traffic clerks",463500,330111,133389,30729,31211,29372
2014,"...Stock clerks and order fillers",829783,546352,283431,26605,27108,25745
2014,"...Weighers, measurers, checkers, and samplers, recordkeeping",62783,33794,28989,34284,39691,31033
2014,"...Secretaries and administrative assistants",2267963,109810,2158153,36141,41073,36004
2014,"...Computer operators",64280,35029,29251,41218,50004,35821
2014,"...Data entry keyers",236645,50011,186634,31421,35479,30850
2014,"...Word processors and typists",194758,29341,165417,33942,35117,33695
2014,"...Desktop publishers",1847,767,1080,50779,50962,47443
2014,"...Insurance claims and policy processing clerks",298694,55430,243264,36111,39019,35733
2014,"...Mail clerks and mail machine operators, except postal service",51096,24983,26113,30003,31673,26519
2014,"...Office clerks, general",798828,141921,656907,32573,37853,32053
2014,"...Office machine operators, except computer",18384,8958,9426,31607,35214,30327
2014,"...Proofreaders and copy markers",6117,1817,4300,36265,36679,36101
2014,"...Statistical assistants",13979,5360,8619,45281,60366,41460
2014,"...Office and administrative support workers, all other",471807,121141,350666,39222,42369,37669
2014,".Natural Resources, Construction, and Maintenance Occupations:",9807518,9424631,382887,40609,40818,30881
2014,"..Farming, Fishing, and Forestry Occupations:",644459,536156,108303,25282,26500,18915
2014,"...First-line supervisors of farming, fishing, and forestry workers",44409,38603,5806,40046,40935,27206
2014,"...Agricultural inspectors",10560,6890,3670,50215,47665,58503
2014,"...Animal breeders",2494,2059,435,31763,31537,32098
2014,"...Graders and sorters, agricultural products",34810,12600,22210,20512,25403,18205
2014,"...Miscellaneous agricultural workers",479993,406702,73291,23645,25119,17718
2014,"...Fishing and hunting workers",19945,19198,747,31952,32300,21692
2014,"...Forest and conservation workers",9445,7846,1599,32067,31899,36898
2014,"...Logging workers",42803,42258,545,31746,31725,40922
2014,"..Construction and Extraction Occupations:",5306587,5174910,131677,40042,40133,32481
2014,"...First-line supervisors of construction trades and extraction workers",608875,593015,15860,57855,57943,56697
2014,"...Boilermakers",12626,12240,386,55449,54633,61484
2014,"...Brickmasons, blockmasons, and stonemasons",80656,79524,1132,33296,32934,37068
2014,"...Carpenters",785306,774823,10483,34967,35074,26575
2014,"...Carpet, floor, and tile installers and finishers",101337,99786,1551,31696,31799,18773
2014,"...Cement masons, concrete finishers, and terrazzo workers",35697,35186,511,32090,32050,50698
2014,"...Construction laborers",1113361,1083386,29975,31395,31434,29338
2014,"...Operating engineers and other construction equipment operators, including pile-driver operators",254237,250082,4155,45048,45089,42351
2014,"...Drywall installers, ceiling tile installers, and tapers",94066,90296,3770,28979,29403,25106
2014,"...Electricians",591640,577579,14061,49809,50079,36276
2014,"...Glaziers",33384,32552,832,36785,37167,27803
2014,"...Insulation workers",36601,35735,866,37270,37390,35809
2014,"...Painters, construction and maintenance",365280,348513,16767,30317,30488,25519
2014,"...Pipelayers, plumbers, pipefitters, and steamfitters",415539,410851,4688,43790,43979,35301
2014,"...Plasterers and stucco masons",17452,17310,142,30975,30904,52162
2014,"...Reinforcing iron and rebar workers",3839,3394,445,35893,35280,37461
2014,"...Roofers",114990,113772,1218,29618,29658,27010
2014,"...Sheet metal workers",102627,98525,4102,40254,40393,34294
2014,"...Structural iron and steel workers",45105,44229,876,45592,45896,19964
2014,"...Helpers, construction trades",28502,27465,1037,26805,26857,23064
2014,"...Construction and building inspectors",67847,61472,6375,51884,52679,42189
2014,"...Hazardous materials removal workers",23523,20412,3111,42087,45173,30026
2014,"...Highway maintenance workers",83359,81025,2334,38267,38457,32204
2014,"...Rail-track laying and maintenance equipment operators",12818,12470,348,49788,50119,23911
2014,"...Septic tank servicers and sewer pipe cleaners",7362,6932,430,40914,40902,60023
2014,"...Miscellaneous construction and related workers, including solar photovoltaic installers",24033,23386,647,40310,40093,43816
2014,"...Derrick, rotary drill, and service unit operators, oil, gas, and mining",30927,30023,904,66914,66299,100584
2014,"...Explosives workers, ordnance handling experts, and blasters",7651,6995,656,56525,57128,52200
2014,"...Mining machine operators",58432,56917,1515,61797,61769,66211
2014,"...Other extraction workers",61453,59880,1573,54975,55072,54298
2014,"..Installation, Maintenance, and Repair Occupations:",3856472,3713565,142907,44262,44462,41195
2014,"...First-line supervisors of mechanics, installers, and repairers",247081,229489,17592,56080,56361,51749
2014,"...Computer, automated teller, and office machine repairers",155340,136375,18965,42483,42490,42400
2014,"...Radio and telecommunications equipment installers and repairers",138077,121794,16283,54815,55556,50223
2014,"...Avionics technicians",17128,15328,1800,56452,56030,61741
2014,"...Electric motor, power tool, and related repairers",20957,19802,1155,48968,49388,46989
2014,"...Electrical and electronics repairers, industrial and utility",10327,9440,887,69019,70833,31137
2014,"...Electronic equipment installers and repairers, motor vehicles",10304,9724,580,42208,41694,53434
2014,"...Electronic home entertainment equipment installers and repairers",31737,30952,785,40723,40923,23605
2014,"...Security and fire alarm systems installers",43095,42192,903,44478,44955,33279
2014,"...Aircraft mechanics and service technicians",131138,124135,7003,60063,60472,33862
2014,"...Automotive body and related repairers",120366,118270,2096,38069,38474,25700
2014,"...Automotive glass installers and repairers",14403,13939,464,35875,35783,51858
2014,"...Automotive service technicians and mechanics",708988,698019,10969,35783,35825,31006
2014,"...Bus and truck mechanics and diesel engine specialists",244443,241134,3309,44796,44692,48217
2014,"...Heavy vehicle and mobile equipment service technicians and mechanics",179975,178524,1451,50234,50229,51960
2014,"...Small engine mechanics",36074,35509,565,33243,33801,26549
2014,"...Miscellaneous vehicle and mobile equipment mechanics, installers, and repairers",52219,51973,246,26509,26462,42000
2014,"...Control and valve installers and repairers",15923,14911,1012,53367,52488,55819
2014,"...Heating, air conditioning, and refrigeration mechanics and installers",285439,282558,2881,43023,43049,42083
2014,"...Home appliance repairers",27045,26338,707,35922,36247,11080
2014,"...Industrial and refractory machinery mechanics",320231,310684,9547,49975,50212,33924
2014,"...Maintenance and repair workers, general",455450,440143,15307,42330,42378,40901
2014,"...Maintenance workers, machinery",25421,24401,1020,46228,46518,34629
2014,"...Millwrights",37508,36471,1037,59275,60063,26845
2014,"...Electrical power-line installers and repairers",99261,98434,827,70579,70544,80980
2014,"...Telecommunications line installers and repairers",114904,108814,6090,50352,50306,50778
2014,"...Precision instrument and equipment repairers",48521,44066,4455,49569,50694,37416
2014,"...Coin, vending, and amusement machine servicers and repairers",26705,23680,3025,35071,35511,30804
2014,"...Locksmiths and safe repairers",17618,16688,930,41155,41324,36616
2014,"...Manufactured building and mobile home installers",4358,3773,585,27975,28094,27672
2014,"...Helpers--installation, maintenance, and repair workers",15393,14021,1372,27725,27592,40141
2014,"...Other installation, maintenance, and repair workers, including wind turbine service technicians",183416,174822,8594,38808,39292,33874
2014,"..Production Occupations:",7047746,5254651,1793095,35891,40113,26561
2014,"...First-line supervisors of production and operating workers",816079,666603,149476,51771,54300,40885
2014,"...Aircraft structure, surfaces, rigging, and systems assemblers",5213,3519,1694,41502,50719,30327
2014,"...Electrical, electronics, and electromechanical assemblers",105081,53326,51755,29466,32037,26225
2014,"...Engine and other machine assemblers",11797,10235,1562,43804,45531,33914
2014,"...Structural metal fabricators and fitters",22590,21605,985,41335,41450,38768
2014,"...Miscellaneous assemblers and fabricators",796167,516231,279936,30860,32369,26764
2014,"...Bakers",134823,68615,66208,24716,26599,21937
2014,"...Butchers and other meat, poultry, and fish processing workers",190986,148006,42980,28251,30576,23376
2014,"...Food and tobacco roasting, baking, and drying machine operators and tenders",5615,3821,1794,31989,40384,21941
2014,"...Food batchmakers",54655,25568,29087,27119,31660,24710
2014,"...Food cooking machine operators and tenders",6032,3826,2206,29500,28892,30404
2014,"...Food processing workers, all other",103888,71012,32876,30222,31163,27164
2014,"...Computer control programmers and operators",73475,68096,5379,44477,45314,36908
2014,"...Extruding and drawing machine setters, operators, and tenders, metal and plastic",10628,9371,1257,36487,37160,30716
2014,"...Forging machine setters, operators, and tenders, metal and plastic",6713,6573,140,40213,40276,36667
2014,"...Rolling machine setters, operators, and tenders, metal and plastic",7334,5388,1946,36745,41082,34784
2014,"...Cutting, punching, and press machine setters, operators, and tenders, metal and plastic",67361,54074,13287,32109,33704,26228
2014,"...Drilling and boring machine tool setters, operators, and tenders, metal and plastic",4392,3918,474,37299,40449,25875
2014,"...Grinding, lapping, polishing, and buffing machine tool setters, operators, and tenders, metal and plastic",40553,36065,4488,35032,35366,31274
2014,"...Lathe and turning machine tool setters, operators, and tenders, metal and plastic",8993,8245,748,41151,41808,30361
2014,"...Milling and planing machine setters, operators, and tenders, metal and plastic",1209,1105,104,27193,27220,21667
2014,"...Machinists",325737,312996,12741,45348,45703,36037
2014,"...Metal furnace operators, tenders, pourers, and casters",20557,19649,908,41694,42324,24758
2014,"...Model makers and patternmakers, metal and plastic",4953,4243,710,52454,56152,42316
2014,"...Molders and molding machine setters, operators, and tenders, metal and plastic",33297,26025,7272,35424,36575,30828
2014,"...Multiple machine tool setters, operators, and tenders, metal and plastic",3601,3082,519,40328,40971,35596
2014,"...Tool and die makers",52437,51301,1136,52840,53158,40671
2014,"...Welding, soldering, and brazing workers",507586,479944,27642,39371,40048,30576
2014,"...Heat treating equipment setters, operators, and tenders, metal and plastic",6883,6474,409,39515,39286,47461
2014,"...Layout workers, metal and plastic",7202,6738,464,41710,42056,7447
2014,"...Plating and coating machine setters, operators, and tenders, metal and plastic",13349,11756,1593,32844,33717,23317
2014,"...Tool grinders, filers, and sharpeners",4744,4206,538,37108,40120,11921
2014,"...Metal workers and plastic workers, all other",327533,257556,69977,33543,36084,26883
2014,"...Prepress technicians and workers",23027,12359,10668,35730,38750,30751
2014,"...Printing workers, except prepress technicians and workers",161075,127666,33409,36032,38735,27047
2014,"...Laundry and dry-cleaning workers",123108,53643,69465,21818,25658,20175
2014,"...Pressers, textile, garment, and related materials",27738,11789,15949,20726,26958,18203
2014,"...Sewing machine operators",131301,37986,93315,21046,22705,20553
2014,"...Shoe and leather workers and repairers",6811,5365,1446,22535,23836,16783
2014,"...Shoe machine operators and tenders",3372,1399,1973,26917,27860,26618
2014,"...Tailors, dressmakers, and sewers",42695,14546,28149,26373,31520,24129
2014,"...Textile bleaching and dyeing machine operators and tenders",3636,2571,1065,25546,25951,22306
2014,"...Textile cutting machine setters, operators, and tenders",6055,4443,1612,26584,28294,16828
2014,"...Textile knitting and weaving machine setters, operators, and tenders",6424,2305,4119,30671,32454,30236
2014,"...Textile winding, twisting, and drawing out machine setters, operators, and tenders",10083,4484,5599,26099,27544,24357
2014,"...Fabric and apparel patternmakers",2304,487,1817,51661,54917,51546
2014,"...Upholsterers",25207,20931,4276,28450,30614,25055
2014,"...Miscellaneous textile, apparel, and furnishings workers, including extruding and forming machine setters, operators, and tenders, synthetic and glass fibers",13973,9476,4497,27055,27507,26217
2014,"...Cabinetmakers and bench carpenters",43107,40987,2120,31453,31498,27234
2014,"...Furniture finishers",9708,8055,1653,28150,30625,24344
2014,"...Sawing machine setters, operators, and tenders, wood",25601,23721,1880,27147,27425,25624
2014,"...Woodworking machine setters, operators, and tenders, except sawing",14401,12320,2081,27081,28391,21618
2014,"...Miscellaneous woodworkers, including model makers and patternmakers",19152,17451,1701,32078,32850,21865
2014,"...Power plant operators, distributors, and dispatchers",42069,40031,2038,80491,80741,75684
2014,"...Stationary engineers and boiler operators",72810,70470,2340,56372,56873,40792
2014,"...Water and wastewater treatment plant and system operators",77537,74364,3173,46654,46712,41310
2014,"...Miscellaneous plant and system operators",35897,32870,3027,64422,65610,46611
2014,"...Chemical processing machine setters, operators, and tenders",49740,44141,5599,51330,52007,36241
2014,"...Crushing, grinding, polishing, mixing, and blending workers",77424,68323,9101,36940,37868,29334
2014,"...Cutting workers",47784,36316,11468,28343,30782,21981
2014,"...Extruding, forming, pressing, and compacting machine setters, operators, and tenders",25281,21996,3285,35956,36816,28433
2014,"...Furnace, kiln, oven, drier, and kettle operators and tenders",10960,9793,1167,46312,46117,49728
2014,"...Inspectors, testers, sorters, samplers, and weighers",651046,422158,228888,40334,46622,30672
2014,"...Jewelers and precious stone and metal workers",27267,19997,7270,31904,38194,21932
2014,"...Medical, dental, and ophthalmic laboratory technicians",61289,30202,31087,36689,40940,34086
2014,"...Packaging and filling machine operators and tenders",204716,100367,104349,25327,28310,22746
2014,"...Painting workers",111570,99214,12356,36655,37361,27478
2014,"...Photographic process workers and processing machine operators",24063,12563,11500,28406,38140,22254
2014,"...Semiconductor processors",1842,1121,721,36199,36624,35526
2014,"...Adhesive bonding machine operators and tenders",7013,4559,2454,35672,41820,21858
2014,"...Cleaning, washing, and metal pickling equipment operators and tenders",5395,3542,1853,30043,35086,25778
2014,"...Etchers and engravers",6350,4775,1575,32366,35976,26367
2014,"...Molders, shapers, and casters, except metal and plastic",22359,19670,2689,32152,34116,22129
2014,"...Paper goods machine setters, operators, and tenders",21451,17286,4165,41050,49539,21531
2014,"...Tire builders",11516,10922,594,50843,50906,48971
2014,"...Helpers--production workers",28067,22112,5955,27463,30078,22101
2014,"...Production workers, all other",942025,704868,237157,32296,35949,26504
2014,"..Transportation Occupations:",3777077,3408321,368756,40763,41394,31001
2014,"...Supervisors of transportation and material moving workers",180426,146478,33948,50717,52151,39700
2014,"...Aircraft pilots and flight engineers",86766,83117,3649,99152,100263,64765
2014,"...Air traffic controllers and airfield operations specialists",32904,24882,8022,89236,90321,81404
2014,"...Flight attendants",50986,11818,39168,44303,53200,42237
2014,"...Ambulance drivers and attendants, except emergency medical technicians",10871,7848,3023,23850,27537,20670
2014,"...Bus drivers",267775,161334,106441,32414,36535,27795
2014,"...Driver/sales workers and truck drivers",2569929,2455007,114922,40913,41201,30173
2014,"...Taxi drivers and chauffeurs",237024,210214,26810,27206,28081,23131
2014,"...Motor vehicle operators, all other",20578,17369,3209,26489,26820,25587
2014,"...Locomotive engineers and operators",46130,44021,2109,78092,78583,61334
2014,"...Railroad conductors and yardmasters",46802,44966,1836,65538,66317,47697
2014,"...Subway, streetcar, and other rail transportation workers",11165,9845,1320,61113,61943,52345
2014,"...Sailors and marine oilers",15078,14524,554,43772,43583,45610
2014,"...Ship and boat captains and operators",26446,26132,314,60418,60870,21157
2014,"...Ship engineers",3119,2937,182,89141,100129,23896
2014,"...Bridge and lock tenders",2746,2017,729,50870,58365,30232
2014,"...Parking lot attendants",43942,38141,5801,24865,25416,20614
2014,"...Automotive and watercraft service attendants",51714,46618,5096,21903,22045,20550
2014,"...Transportation inspectors",41802,35678,6124,57458,60550,40845
2014,"...Transportation attendants, except flight attendants",10943,6974,3969,32938,41391,26631
2014,"...Other transportation workers",16123,14593,1530,36973,36573,43882
2014,"..Material Moving Occupations:",2508538,2051032,457506,30037,30982,23841
2014,"...Conveyor operators and tenders",4462,3564,898,37988,38779,36176
2014,"...Crane and tower operators",56717,55289,1428,51753,51748,51867
2014,"...Dredge, excavating, and loading machine operators",24385,24257,128,45314,45190,51364
2014,"...Hoist and winch operators",5627,5074,553,39610,37671,65856
2014,"...Industrial truck and tractor operators",446646,416492,30154,31579,31580,31558
2014,"...Cleaners of vehicles and equipment",217057,191159,25898,24655,25047,21828
2014,"...Laborers and freight, stock, and material movers, hand",1333857,1113986,219871,30256,30949,25457
2014,"...Machine feeders and offbearers",16791,10533,6258,26963,28868,23022
2014,"...Packers and packagers, hand",274739,113331,161408,22107,24295,21153
2014,"...Pumping station operators",24642,23111,1531,60028,60028,60208
2014,"...Refuse and recyclable material collectors",66445,61465,4980,30571,30512,32203
2014,"...Tank car, truck, and ship loaders",3994,3498,496,32318,33566,19329
2014,"...Material moving workers, all other",31845,27996,3849,36333,36930,31958
2015,"Chief executives",1040875,796280,244595,126200,140057,101496
2015,"General and operations managers",820262,582065,238197,69820,75067,57384
2015,"Legislators",11383,6260,5123,61769,70789,56731
2015,"Advertising and promotions managers",42778,19268,23510,61440,70913,55329
2015,"Marketing and sales managers",819708,463834,355874,80734,95761,65921
2015,"Public relations and fundraising managers",52633,19478,33155,78347,84675,72278
2015,"Administrative services managers",135020,81001,54019,61901,68249,56589
2015,"Computer and information systems managers",550033,400987,149046,101338,104424,92260
2015,"Financial managers",1075868,514557,561311,75203,97095,60996
2015,"Compensation and benefits managers",18273,4488,13785,77079,106935,70594
2015,"Human resources managers",346818,136261,210557,71789,80464,67815
2015,"Training and development managers",45083,22499,22584,74067,75903,71835
2015,"Industrial production managers",224674,180386,44288,73812,76055,66667
2015,"Purchasing managers",180237,94739,85498,71940,81136,65993
2015,"Transportation, storage, and distribution managers",208783,168799,39984,52382,53030,51266
2015,"Farmers, ranchers, and other agricultural managers",478065,425953,52112,41566,42400,28800
2015,"Construction managers",519273,481677,37596,70871,71257,61768
2015,"Education administrators",725830,262810,463020,70002,80060,62613
2015,"Architectural and engineering managers",142692,130504,12188,126098,125849,131780
2015,"Food service managers",799339,440295,359044,36830,41550,31660
2015,"Funeral service managers",6678,5043,1635,58968,62545,51774
2015,"Gaming managers",15573,9255,6318,51822,60539,45571
2015,"Lodging managers",111620,57502,54118,42869,49199,40726
2015,"Medical and health services managers",584635,172461,412174,70550,83190,65667
2015,"Natural sciences managers",19346,9350,9996,78026,101096,70411
2015,"Postmasters and mail superintendents",20609,9897,10712,69456,74036,64742
2015,"Property, real estate, and community association managers",461757,234252,227505,52153,61333,46957
2015,"Social and community service managers",293821,95879,197942,55506,66320,51472
2015,"Emergency management directors",6950,4429,2521,61161,61088,61302
2015,"Managers, all other",3681343,2443030,1238313,76680,82139,66153
2015,"Business and Financial Operations Occupations",5914658,2699566,3215092,61547,71816,55043
2015,"Agents and business managers of artists, performers, and athletes",28197,16204,11993,55086,60167,43617
2015,"Buyers and purchasing agents, farm products",8890,6538,2352,50504,51087,43750
2015,"Wholesale and retail buyers, except farm products",138703,70538,68165,42479,41549,45473
2015,"Purchasing agents, except wholesale, retail, and farm products",243673,116426,127247,52118,56516,50429
2015,"Claims adjusters, appraisers, examiners, and investigators",264364,106214,158150,51638,58069,48172
2015,"Compliance officers",203916,96365,107551,65541,70880,60193
2015,"Cost estimators",117961,102374,15587,62038,65039,47652
2015,"Human resources workers",622517,165517,457000,55712,62608,52960
2015,"Compensation, benefits, and job analysis specialists",49272,9570,39702,50547,66311,48544
2015,"Training and development specialists",124732,55168,69564,56712,65481,51318
2015,"Logisticians",118827,80188,38639,51414,53598,49257
2015,"Management analysts",601323,356627,244696,81491,90316,72526
2015,"Meeting, convention, and event planners",84357,18995,65362,46795,52198,46016
2015,"Fundraisers",69606,18867,50739,60257,70945,57197
2015,"Market research analysts and marketing specialists",223163,101313,121850,67036,80482,60564
2015,"Business operations specialists, all other",240307,113340,126967,61388,71857,52542
2015,"Accountants and auditors",1590845,635022,955823,61630,74290,55355
2015,"Appraisers and assessors of real estate",75621,48090,27531,55113,62041,45713
2015,"Budget analysts",42992,18004,24988,75207,83503,72121
2015,"Credit analysts",25831,11562,14269,51742,54170,50368
2015,"Financial analysts",191432,113535,77897,80779,86313,73117
2015,"Personal financial advisors",310815,216465,94350,87023,100744,62398
2015,"Insurance underwriters",100406,36810,63596,61257,70294,56889
2015,"Financial examiners",11144,5834,5310,79197,86633,76190
2015,"Credit counselors and loan officers",273231,120061,153170,55986,75368,47329
2015,"Tax examiners and collectors, and revenue agents",50457,16381,34076,51028,62186,47388
2015,"Tax preparers",52627,22243,30384,52136,62228,45869
2015,"Financial specialists, all other",49449,21315,28134,64187,92271,50356
2015,"Computer, Engineering, and Science Occupations",7040467,5355898,1684569,77400,81089,68236
2015,"Computer and Mathematical Occupations",3679444,2766278,913166,80339,82130,71378
2015,"Computer and information research scientists",16892,12047,4845,80981,85716,71493
2015,"Computer systems analysts",426775,265833,160942,77420,82774,70706
2015,"Information security analysts",62969,50625,12344,87209,90764,75800
2015,"Computer programmers",381192,300845,80347,83138,85773,77459
2015,"Software developers, applications and systems software",1037453,839190,198263,97763,100697,86856
2015,"Web developers",139635,93046,46589,61543,62432,58768
2015,"Computer support specialists",528080,400613,127467,56777,57650,52583
2015,"Database administrators",98628,64000,34628,76971,86021,64495
2015,"Network and computer systems administrators",190100,156374,33726,70574,71367,65148
2015,"Computer network architects",103813,94936,8877,95506,95720,92370
2015,"Computer occupations, all other",502477,386665,115812,69200,70207,66684
2015,"Actuaries",22141,14827,7314,102240,112444,92323
2015,"Mathematicians",2100,1291,809,86951,103750,65179
2015,"Operations research analysts",129326,66333,62993,77057,86722,70289
2015,"Statisticians",33912,17309,16603,83209,87300,80260
2015,"Miscellaneous mathematical science occupations",3951,2344,1607,76250,82500,62345
2015,"Architecture and Engineering Occupations",2353916,2024657,329259,80270,81198,70435
2015,"Architects, except naval",147505,111828,35677,76033,80488,63891
2015,"Surveyors, cartographers, and photogrammetrists",25698,21372,4326,61862,62003,56677
2015,"Aerospace engineers",104657,92536,12121,101228,102004,90768
2015,"Agricultural engineers",3091,2915,176,78423,78679,47268
2015,"Biomedical engineers",11102,9850,1252,76167,76923,62000
2015,"Chemical engineers",56266,47775,8491,100960,100944,101063
2015,"Civil engineers",276172,242805,33367,82611,85482,75346
2015,"Computer hardware engineers",47062,40447,6615,95440,97034,84479
2015,"Electrical and electronics engineers",190417,174106,16311,92880,95103,81359
2015,"Environmental engineers",25754,19312,6442,80846,82150,75857
2015,"Industrial engineers, including health and safety",179731,145147,34584,76826,77713,71361
2015,"Marine engineers and naval architects",10832,10002,830,90353,90095,100404
2015,"Materials engineers",38312,33756,4556,80694,81705,69452
2015,"Mechanical engineers",225549,206416,19133,82760,83340,80750
2015,"Mining and geological engineers, including mining safety engineers",9279,8253,1026,89517,87399,101360
2015,"Nuclear engineers",6116,5449,667,111462,113113,102149
2015,"Petroleum engineers",28922,25358,3564,125678,131162,111271
2015,"Engineers, all other",474766,412308,62458,92062,95216,81156
2015,"Drafters",124921,104061,20860,51609,52192,47475
2015,"Engineering technicians, except drafters",316833,263123,53710,55024,56580,46172
2015,"Surveying and mapping technicians",50931,47838,3093,50504,50771,45360
2015,"Life, Physical, and Social Science Occupations",1007107,564963,442144,65215,70726,59905
2015,"Agricultural and food scientists",17366,11069,6297,61150,70009,54178
2015,"Biological scientists",62763,33697,29066,61141,62192,60114
2015,"Conservation scientists and foresters",17087,13930,3157,52470,55144,51359
2015,"Medical scientists",118091,59308,58783,75438,82246,67361
2015,"Life scientists, all other",10172,5461,4711,72742,74723,60413
2015,"Astronomers and physicists",8276,7232,1044,100407,100634,86477
2015,"Atmospheric and space scientists",8367,6577,1790,82852,86926,68836
2015,"Chemists and materials scientists",74050,44599,29451,67342,73671,63822
2015,"Environmental scientists and geoscientists",58056,41197,16859,77010,81693,67141
2015,"Physical scientists, all other",180602,107571,73031,77740,86695,66893
2015,"Economists",22836,15043,7793,103467,111549,95733
2015,"Survey researchers",929,493,436,90354,106250,70950
2015,"Psychologists",122868,38661,84207,71416,85861,66765
2015,"Urban and regional planners",20118,11843,8275,71387,72133,70053
2015,"Miscellaneous social scientists and related workers, including sociologists",23218,13124,10094,66855,70191,61742
2015,"Agricultural and food science technicians",30579,20012,10567,46084,50753,37219
2015,"Biological technicians",17556,8664,8892,50100,51100,46928
2015,"Chemical technicians",59673,40557,19116,52119,55771,48499
2015,"Geological and petroleum technicians",16682,13285,3397,73543,75499,61777
2015,"Nuclear technicians",3383,2432,951,71703,75769,61483
2015,"Social science research assistants",2205,775,1430,42435,52552,42284
2015,"Miscellaneous life, physical, and social science technicians",132230,69433,62797,42427,46514,40928
2015,"Education, Legal, Community Service, Arts, and Media Occupations",10353405,3948912,6404493,50417,57809,46386
2015,"Community and Social Service Occupations",1937719,694893,1242826,42461,45658,41893
2015,"Counselors",547839,159706,388133,44100,45444,43490
2015,"Social workers",693187,129081,564106,42350,45076,42172
2015,"Probation officers and correctional treatment specialists",83528,42632,40896,48528,50128,46479
2015,"Social and human service assistants",134496,28824,105672,37178,41363,36551
2015,"Miscellaneous community and social service specialists, including health educators and community health workers",65726,19664,46062,44030,48495,41334
2015,"Clergy",329537,277594,51943,44518,45275,41604
2015,"Directors, religious activities and education",47490,23089,24401,41935,49056,38554
2015,"Religious workers, all other",35916,14303,21613,36943,42330,35712
2015,"Legal Occupations",1392166,698172,693994,84791,120270,64121
2015,"Lawyers",879090,569258,309832,120930,130914,101441
2015,"Judicial law clerks",12429,6332,6097,55499,51492,59954
2015,"Judges, magistrates, and other judicial workers",53899,29676,24223,101014,121650,71919
2015,"Paralegals and legal assistants",316583,52309,264274,48453,50668,48007
2015,"Miscellaneous legal support workers",130165,40597,89568,51139,61075,46881
2015,"Education, Training, and Library Occupations",5240692,1530438,3710254,48649,55772,45789
2015,"Postsecondary teachers",879141,469912,409229,65629,71485,61046
2015,"Preschool and kindergarten teachers",340735,9808,330927,24938,27004,24853
2015,"Elementary and middle school teachers",2316620,513022,1803598,50192,52182,49006
2015,"Secondary school teachers",542418,234178,308240,51915,55088,50921
2015,"Special education teachers",168678,26883,141795,48795,49731,48593
2015,"Other teachers and instructors",354049,161351,192698,43893,50979,38426
2015,"Archivists, curators, and museum technicians",32237,13806,18431,50931,51822,50497
2015,"Librarians",108825,21011,87814,50871,53810,50445
2015,"Library technicians",16438,3363,13075,36316,40776,33668
2015,"Teacher assistants",410201,55703,354498,22150,30116,21578
2015,"Other education, training, and library workers",71350,21401,49949,56213,59029,55296
2015,"Arts, Design, Entertainment, Sports, and Media Occupations",1782828,1025409,757419,51446,55746,47131
2015,"Artists and related workers",115100,73567,41533,48915,52071,37468
2015,"Designers",608355,317723,290632,51545,60191,45100
2015,"Actors",13079,8901,4178,50567,50634,50465
2015,"Producers and directors",117179,76866,40313,62387,66940,56781
2015,"Athletes, coaches, umpires, and related workers",109943,80600,29343,45098,47073,40589
2015,"Dancers and choreographers",7439,1485,5954,39519,65504,36413
2015,"Musicians, singers, and related workers",65350,48840,16510,42428,45378,41193
2015,"Entertainers and performers, sports and related workers, all other",17704,10091,7613,40012,42109,32127
2015,"Announcers",27522,22529,4993,50378,51039,43471
2015,"News analysts, reporters and correspondents",56131,32885,23246,48528,48247,48698
2015,"Public relations specialists",101879,38269,63610,62272,69604,59513
2015,"Editors",126515,59212,67303,54548,60200,51463
2015,"Technical writers",43179,19675,23504,68642,71559,63665
2015,"Writers and authors",131816,62166,69650,56930,61418,52418
2015,"Miscellaneous media and communication workers",50676,20443,30233,41667,50807,37989
2015,"Miscellaneous media and communications equipment workers, including broadcast and sound engineering technicians and radio operators",72286,67181,5105,51473,51423,52188
2015,"Photographers",80094,51875,28219,41015,45319,35027
2015,"Television, video, and motion picture camera operators and editors",38581,33101,5480,46655,48293,41274
2015,"Healthcare Practitioners and Technical Occupations",6285534,1728301,4557233,60928,80084,56629
2015,"Chiropractors",35155,28258,6897,76291,81498,61416
2015,"Dentists",95713,68320,27393,150649,156658,120689
2015,"Dietitians and nutritionists",61678,5866,55812,50322,43293,50820
2015,"Optometrists",25706,15220,10486,110566,121126,100790
2015,"Pharmacists",211639,98435,113204,120111,121379,115189
2015,"Physicians and surgeons",715361,477655,237706,200203,221528,150975
2015,"Physician assistants",72551,25324,47227,97462,106335,92087
2015,"Podiatrists",5562,4038,1524,116654,122430,100562
2015,"Audiologists",12077,1986,10091,73355,82171,71948
2015,"Occupational therapists",64761,8911,55850,69738,72440,68000
2015,"Physical therapists",157932,58144,99788,75836,81239,71898
2015,"Radiation therapists",12812,4172,8640,80607,81022,80320
2015,"Recreational therapists",7445,1668,5777,41480,44892,40508
2015,"Respiratory therapists",83930,32558,51372,55793,61589,51928
2015,"Speech-language pathologists",88903,5343,83560,61989,73661,61669
2015,"Miscellaneous therapists, including exercise physiologists",99352,21447,77905,46386,46534,46364
2015,"Veterinarians",56815,25816,30999,90378,101745,81649
2015,"Registered nurses",2227835,267866,1959969,62636,68759,62268
2015,"Nurse anesthetists",22833,10381,12452,152610,170331,148873
2015,"Nurse practitioners",97121,10196,86925,96461,100847,96174
2015,"Health diagnosing and treating practitioners, all other",13144,4512,8632,53226,72059,52231
2015,"Clinical laboratory technologists and technicians",246437,69100,177337,47531,51066,46582
2015,"Dental hygienists",68943,5525,63418,59700,80648,56796
2015,"Diagnostic related technologists and technicians",259914,89534,170380,56328,61703,53309
2015,"Emergency medical technicians and paramedics",157142,108751,48391,40915,42618,35720
2015,"Health practitioner support technologists and technicians",429026,92445,336581,31830,35843,31348
2015,"Licensed practical and licensed vocational nurses",572705,69904,502801,38441,41171,37816
2015,"Medical records and health information technicians",143058,13585,129473,37102,41133,36939
2015,"Opticians, dispensing",37530,11702,25828,38961,46848,34335
2015,"Miscellaneous health technologists and technicians",96956,33669,63287,40495,46975,37077
2015,"Other healthcare practitioners and technical occupations",101327,57917,43410,57131,61243,52188
2015,"Healthcare Support Occupations",2153516,305544,1847972,27470,30921,27170
2015,"Nursing, psychiatric, and home health aides",1214020,172611,1041409,25743,28461,25390
2015,"Occupational therapy assistants and aides",12756,1574,11182,47302,45980,48391
2015,"Physical therapist assistants and aides",53025,16778,36247,45648,47197,44485
2015,"Massage therapists",60133,15529,44604,30667,31658,30422
2015,"Dental assistants",165817,10936,154881,31502,37076,31398
2015,"Medical assistants",376800,30913,345887,30085,32623,29872
2015,"Medical transcriptionists",29196,1532,27664,32279,45282,32182
2015,"Pharmacy aides",28588,6246,22342,31500,36714,30968
2015,"Veterinary assistants and laboratory animal caretakers",29360,4998,24362,25504,38167,24205
2015,"Phlebotomists",85128,10946,74182,30497,32277,30295
2015,"Healthcare support workers, all other, including medical equipment preparers",98693,33481,65212,30366,31975,28420
2015,"Protective Service Occupations",2510047,2026265,483782,50594,52118,40787
2015,"First-line supervisors of correctional officers",55327,39436,15891,53522,57390,46185
2015,"First-line supervisors of police and detectives",94175,79588,14587,80336,81985,63504
2015,"First-line supervisors of fire fighting and prevention workers",44798,42954,1844,86453,86611,70567
2015,"First-line supervisors of protective service workers, all other",64548,50047,14501,49384,50301,46813
2015,"Firefighters",254678,242900,11778,65336,65586,56817
2015,"Fire inspectors",17545,15551,1994,55762,57478,42298
2015,"Bailiffs, correctional officers, and jailers",376460,275225,101235,43558,46825,38088
2015,"Detectives and criminal investigators",118191,88512,29679,76843,80877,65511
2015,"Fish and game wardens",4175,3855,320,50041,48576,60694
2015,"Parking enforcement workers",6393,3673,2720,41431,37006,42985
2015,"Police and sheriff patrol officers",662619,572681,89938,62358,64391,55331
2015,"Transit and railroad police",2915,2426,489,44818,55634,43541
2015,"Animal control workers",8176,5357,2819,35318,32452,40154
2015,"Private detectives and investigators",67589,38415,29174,51899,57277,46210
2015,"Security guards and gaming surveillance officers",675504,529889,145615,30369,30738,28384
2015,"Crossing guards",11204,6289,4915,32430,32407,32494
2015,"Transportation security screeners",23262,14043,9219,41487,41893,39937
2015,"Lifeguards and other recreational, and all other protective service workers",22488,15424,7064,31749,34300,27391
2015,"Food Preparation and Serving Related Occupations",3693996,1983782,1710214,21938,23729,20620
2015,"Chefs and head cooks",328344,264659,63685,30443,31069,26279
2015,"First-line supervisors of food preparation and serving workers",375654,175801,199853,25510,29352,22498
2015,"Cooks",1182829,746447,436382,21062,21975,19307
2015,"Food preparation workers",351007,170381,180626,20038,20744,18987
2015,"Bartenders",212346,105543,106803,27471,30988,25275
2015,"Combined food preparation and serving workers, including fast food",134080,46208,87872,20333,20914,20016
2015,"Counter attendants, cafeteria, food concession, and coffee shop",35634,13918,21716,18017,19160,17410
2015,"Waiters and waitresses",733624,270068,463556,21647,24557,20670
2015,"Food servers, nonrestaurant",79506,28337,51169,23071,27147,21718
2015,"Dining room and cafeteria attendants and bartender helpers",103325,64046,39279,20922,21480,19840
2015,"Dishwashers",106946,85964,20982,18589,18905,17399
2015,"Hosts and hostesses, restaurant, lounge, and coffee shop",44521,8472,36049,19298,20684,18930
2015,"Food preparation and serving related workers, all other",6180,3938,2242,20259,20354,19940
2015,"Building and Grounds Cleaning and Maintenance Occupations",3357793,2209972,1147821,25797,28980,21421
2015,"First-line supervisors of housekeeping and janitorial workers",182574,110213,72361,34676,41119,28699
2015,"First-line supervisors of landscaping, lawn service, and groundskeeping workers",122309,115012,7297,39862,40361,31262
2015,"Janitors and building cleaners",1480257,1094360,385897,27319,30302,22334
2015,"Maids and housekeeping cleaners",764870,119625,645245,20720,23513,20284
2015,"Pest control workers",59380,57026,2354,35704,35688,36560
2015,"Grounds maintenance workers",748403,713736,34667,25090,25133,23213
2015,"Personal Care and Service Occupations",2635195,665033,1970162,24280,29220,22718
2015,"First-line supervisors of gaming workers",19441,10764,8677,43523,44981,41027
2015,"First-line supervisors of personal service workers",68182,27460,40722,31871,41640,30040
2015,"Animal trainers",25201,11950,13251,29163,30878,27128
2015,"Nonfarm animal caretakers",122243,37538,84705,25207,27070,24085
2015,"Gaming services workers",66483,36292,30191,40077,40864,38071
2015,"Motion picture projectionists",1715,1259,456,23859,30952,20085
2015,"Ushers, lobby attendants, and ticket takers",8040,4348,3692,24079,25179,22700
2015,"Miscellaneous entertainment attendants and related workers",53319,30018,23301,24148,24652,23445
2015,"Embalmers and funeral attendants",7477,5628,1849,37124,36374,40081
2015,"Morticians, undertakers, and funeral directors",29202,20943,8259,49505,50920,41651
2015,"Barbers",65578,53593,11985,24353,25054,21450
2015,"Hairdressers, hairstylists, and cosmetologists",433958,46909,387049,25292,30221,24932
2015,"Miscellaneous personal appearance workers",172329,33328,139001,21553,21746,21508
2015,"Baggage porters, bellhops, and concierges",58186,46251,11935,31802,31845,31713
2015,"Tour and travel guides",17915,11913,6002,27135,30271,22380
2015,"Childcare workers",542799,30617,512182,21100,24039,20933
2015,"Personal care aides",665649,131142,534507,22104,24637,21713
2015,"Recreation and fitness workers",179318,79947,99371,31955,36356,30598
2015,"Residential advisors",27489,10179,17310,26716,25923,27129
2015,"Personal care and service workers, all other",70671,34954,35717,25498,26242,24312
2015,"Sales and Related Occupations",9992545,5884240,4108305,42101,50928,32588
2015,"First-line supervisors of retail sales workers",2584676,1475041,1109635,39844,45509,32506
2015,"First-line supervisors of non-retail sales workers",1083898,774728,309170,62028,65472,57009
2015,"Cashiers",1005103,286829,718274,20671,22496,20074
2015,"Counter and rental clerks",53595,28590,25005,28417,34323,24164
2015,"Parts salespersons",97449,85071,12378,35291,36175,30045
2015,"Retail salespersons",1728842,1062896,665946,31949,37411,26380
2015,"Advertising sales agents",131025,65642,65383,60371,61666,56362
2015,"Insurance sales agents",443784,233599,210185,50612,62445,41451
2015,"Securities, commodities, and financial services sales agents",207926,145614,62312,81122,100162,57102
2015,"Travel agents",51045,11318,39727,40649,47801,38750
2015,"Sales representatives, services, all other",532756,367845,164911,61800,67763,51586
2015,"Sales representatives, wholesale and manufacturing",1180434,876695,303739,62997,67341,52384
2015,"Models, demonstrators, and product promoters",11284,4271,7013,33742,60239,24912
2015,"Real estate brokers and sales agents",558162,277717,280445,53278,61821,49861
2015,"Sales engineers",34183,31961,2222,102095,102397,90274
2015,"Telemarketers",36741,13319,23422,25385,26129,25044
2015,"Door-to-door sales workers, news and street vendors, and related workers",56544,31987,24557,26639,28591,25196
2015,"Sales and related workers, all other",195098,111117,83981,52342,65423,47024
2015,"Office and Administrative Support Occupations",13432640,3885270,9547370,35770,39077,34962
2015,"First-line supervisors of office and administrative support workers",1172641,469845,702796,47727,54330,43758
2015,"Switchboard operators, including answering service",19750,4433,15317,28733,37955,27348
2015,"Telephone operators",25954,6600,19354,30710,31920,30368
2015,"Communications equipment operators, all other",6186,3573,2613,50186,52546,48473
2015,"Bill and account collectors",132795,37946,94849,35374,38114,33961
2015,"Billing and posting clerks",387079,46422,340657,34158,37241,33514
2015,"Bookkeeping, accounting, and auditing clerks",824256,106296,717960,37498,41560,37181
2015,"Gaming cage workers",6141,2078,4063,26255,27482,23911
2015,"Payroll and timekeeping clerks",128515,15431,113084,41274,46039,41018
2015,"Procurement clerks",27334,12321,15013,51576,57057,49581
2015,"Tellers",222682,29290,193392,26514,27256,26428
2015,"Financial clerks, all other",105595,43054,62541,50192,66747,42454
2015,"Brokerage clerks",5325,2033,3292,46724,51212,45709
2015,"Correspondence clerks",4705,1771,2934,34330,41904,33489
2015,"Court, municipal, and license clerks",66156,13832,52324,37256,41402,36849
2015,"Credit authorizers, checkers, and clerks",44112,12277,31835,37200,47358,33911
2015,"Customer service representatives",1718122,603453,1114669,32317,36064,31577
2015,"Eligibility interviewers, government programs",63758,12551,51207,40640,50885,39798
2015,"File clerks",148742,34688,114054,32320,36548,31871
2015,"Hotel, motel, and resort desk clerks",76390,26226,50164,22015,22424,21849
2015,"Interviewers, except eligibility and loan",83520,11504,72016,31550,37615,31059
2015,"Library assistants, clerical",33081,6681,26400,29934,31454,29217
2015,"Loan interviewers and clerks",101161,19877,81284,41230,45544,40723
2015,"New accounts clerks",14475,4181,10294,33666,36388,32294
2015,"Order clerks",92853,38417,54436,31859,33907,30940
2015,"Human resources assistants, except payroll and timekeeping",35349,6847,28502,39349,41347,37429
2015,"Receptionists and information clerks",673178,67446,605732,27482,31364,27260
2015,"Reservation and transportation ticket agents and travel clerks",89592,40313,49279,38389,41690,36558
2015,"Information and record clerks, all other",63591,15875,47716,38533,44875,35837
2015,"Cargo and freight agents",17014,11366,5648,37286,37367,37161
2015,"Couriers and messengers",140185,122486,17699,36487,36854,31658
2015,"Dispatchers",238287,110071,128216,39323,41983,36386
2015,"Meter readers, utilities",23586,20026,3560,40162,39647,41823
2015,"Postal service clerks",95566,44466,51100,55021,56034,51583
2015,"Postal service mail carriers",267230,168843,98387,56356,57818,52221
2015,"Postal service mail sorters, processors, and processing machine operators",53474,25986,27488,53083,55037,51071
2015,"Production, planning, and expediting clerks",270331,114456,155875,46053,56455,39133
2015,"Shipping, receiving, and traffic clerks",479565,334423,145142,30934,31719,28917
2015,"Stock clerks and order fillers",881379,582881,298498,27118,27792,26113
2015,"Weighers, measurers, checkers, and samplers, recordkeeping",60025,35611,24414,36196,41345,30528
2015,"Secretaries and administrative assistants",2292625,120737,2171888,36663,41054,36513
2015,"Computer operators",69473,38242,31231,43932,50154,37483
2015,"Data entry keyers",229754,53801,175953,32124,34723,31807
2015,"Word processors and typists",197811,29650,168161,35048,36611,34604
2015,"Desktop publishers",2316,499,1817,50667,49306,51087
2015,"Insurance claims and policy processing clerks",317490,62343,255147,36838,40237,36406
2015,"Mail clerks and mail machine operators, except postal service",52602,25830,26772,30578,31379,28966
2015,"Office clerks, general",838480,150980,687500,33678,36442,32850
2015,"Office machine operators, except computer",23701,10885,12816,29338,31933,26829
2015,"Proofreaders and copy markers",6526,2181,4345,34559,36940,31797
2015,"Statistical assistants",14662,5747,8915,48936,55617,46423
2015,"Office and administrative support workers, all other",487520,118499,369021,39843,44329,37840
2015,"Natural Resources, Construction, and Maintenance Occupations",10253555,9860449,393106,40928,41124,31210
2015,"Farming, Fishing, and Forestry Occupations",663998,544237,119761,25822,26962,20606
2015,"First-line supervisors of farming, fishing, and forestry workers",50333,43275,7058,40351,40904,36592
2015,"Agricultural inspectors",11709,8054,3655,45894,47088,39794
2015,"Animal breeders",4019,2106,1913,31984,31354,41288
2015,"Graders and sorters, agricultural products",33127,11776,21351,21434,26573,20373
2015,"Miscellaneous agricultural workers",498973,415865,83108,24083,25272,19587
2015,"Fishing and hunting workers",18994,18097,897,37740,38078,26616
2015,"Forest and conservation workers",8844,7653,1191,37657,40396,26661
2015,"Logging workers",37999,37411,588,32026,32102,30577
2015,"Construction and Extraction Occupations",5559833,5418960,140873,40235,40300,35673
2015,"First-line supervisors of construction trades and extraction workers",648913,628502,20411,57174,57434,50654
2015,"Boilermakers",13130,11852,1278,57242,60273,46271
2015,"Brickmasons, blockmasons, and stonemasons",87393,86748,645,36511,36502,37154
2015,"Carpenters",815108,802196,12912,35859,35923,31376
2015,"Carpet, floor, and tile installers and finishers",102910,100694,2216,31201,31265,29262
2015,"Cement masons, concrete finishers, and terrazzo workers",34416,34200,216,33736,33523,42021
2015,"Construction laborers",1171574,1145578,25996,31609,31636,30276
2015,"Operating engineers and other construction equipment operators, including pile-driver operators",259652,254159,5493,45527,45481,47519
2015,"Drywall installers, ceiling tile installers, and tapers",99710,97336,2374,30805,30827,30367
2015,"Electricians",639345,627698,11647,50185,50184,50257
2015,"Glaziers",32153,31688,465,39607,40026,22408
2015,"Insulation workers",31136,29795,1341,37979,39092,21750
2015,"Painters, construction and maintenance",371450,351341,20109,29982,30016,28754
2015,"Pipelayers, plumbers, pipefitters, and steamfitters",441982,436460,5522,45141,45166,42368
2015,"Plasterers and stucco masons",21511,21284,227,30051,30170,17345
2015,"Roofers",131639,130107,1532,30482,30453,31536
2015,"Sheet metal workers",97369,92879,4490,41647,41965,32170
2015,"Structural iron and steel workers",45673,44753,920,47794,47989,41556
2015,"Helpers, construction trades",30324,29434,890,27034,26993,30156
2015,"Construction and building inspectors",71140,63032,8108,52118,53612,41931
2015,"Elevator installers and repairers",21275,20836,439,82347,82844,71327
2015,"Fence erectors",18028,17511,517,28857,29536,24274
2015,"Hazardous materials removal workers",24600,19183,5417,38706,42408,28602
2015,"Highway maintenance workers",91845,90399,1446,40128,40127,40162
2015,"Septic tank servicers and sewer pipe cleaners",9577,9180,397,35765,36171,26473
2015,"Miscellaneous construction and related workers, including solar photovoltaic installers",39573,38998,575,36782,36781,40094
2015,"Derrick, rotary drill, and service unit operators, oil, gas, and mining",26818,26336,482,70632,70566,102795
2015,"Earth drillers, except oil and gas",20248,20129,119,51088,50961,57004
2015,"Explosives workers, ordnance handling experts, and blasters",7931,7453,478,50965,51680,27109
2015,"Mining machine operators",53986,51892,2094,61442,61489,60412
2015,"Other extraction workers",55609,54276,1333,60220,60340,52181
2015,"Installation, Maintenance, and Repair Occupations",4029724,3897252,132472,45414,45515,41070
2015,"First-line supervisors of mechanics, installers, and repairers",251388,237248,14140,58657,59434,51964
2015,"Computer, automated teller, and office machine repairers",158624,140149,18475,42617,43532,40850
2015,"Radio and telecommunications equipment installers and repairers",140980,128098,12882,53181,54618,50750
2015,"Avionics technicians",17537,16038,1499,54056,54178,51594
2015,"Electric motor, power tool, and related repairers",20499,19519,980,43957,45205,31915
2015,"Electrical and electronics repairers, industrial and utility",11609,11155,454,72062,75775,33801
2015,"Electronic equipment installers and repairers, motor vehicles",10870,10635,235,48534,48581,38173
2015,"Electronic home entertainment equipment installers and repairers",33359,32508,851,40129,40382,35242
2015,"Security and fire alarm systems installers",50824,49507,1317,44043,43766,45816
2015,"Aircraft mechanics and service technicians",138813,132003,6810,57438,58198,51819
2015,"Automotive body and related repairers",121541,119979,1562,40400,40462,31274
2015,"Automotive glass installers and repairers",15158,15060,98,40198,40228,30484
2015,"Automotive service technicians and mechanics",704917,696530,8387,36456,36513,31415
2015,"Bus and truck mechanics and diesel engine specialists",270500,267592,2908,44669,44679,43372
2015,"Heavy vehicle and mobile equipment service technicians and mechanics",178864,176522,2342,51251,51285,41659
2015,"Small engine mechanics",33855,33215,640,32320,32302,55310
2015,"Miscellaneous vehicle and mobile equipment mechanics, installers, and repairers",57224,56456,768,27209,27148,31652
2015,"Control and valve installers and repairers",17079,15946,1133,56570,56873,55817
2015,"Heating, air conditioning, and refrigeration mechanics and installers",313922,311314,2608,43178,43252,41457
2015,"Home appliance repairers",30355,29539,816,41352,41508,34718
2015,"Industrial and refractory machinery mechanics",359501,349185,10316,50598,50771,38573
2015,"Maintenance and repair workers, general",433396,419580,13816,42367,42441,39007
2015,"Maintenance workers, machinery",30046,28584,1462,47933,48207,41515
2015,"Millwrights",37854,37304,550,60435,60516,50270
2015,"Electrical power-line installers and repairers",109620,107728,1892,72202,72366,39674
2015,"Telecommunications line installers and repairers",131790,125994,5796,47745,48004,43077
2015,"Precision instrument and equipment repairers",53032,48009,5023,49107,50268,38941
2015,"Coin, vending, and amusement machine servicers and repairers",24663,20953,3710,36519,37016,31808
2015,"Locksmiths and safe repairers",20091,18978,1113,40304,40550,30660
2015,"Manufactured building and mobile home installers",4114,3828,286,24181,22983,30713
2015,"Riggers",7983,7738,245,52418,54591,31449
2015,"Helpers--installation, maintenance, and repair workers",16410,15706,704,26547,26118,42039
2015,"Other installation, maintenance, and repair workers, including wind turbine service technicians",214334,205830,8504,40593,40718,32143
2015,"Production Occupations",7218719,5366548,1852171,36278,40435,27256
2015,"First-line supervisors of production and operating workers",817787,668229,149558,52183,55318,41324
2015,"Aircraft structure, surfaces, rigging, and systems assemblers",6647,5233,1414,40702,41851,26424
2015,"Electrical, electronics, and electromechanical assemblers",106600,54453,52147,30522,32381,27911
2015,"Engine and other machine assemblers",10601,9596,1005,41498,42219,26415
2015,"Structural metal fabricators and fitters",23979,22782,1197,38770,39734,25383
2015,"Miscellaneous assemblers and fabricators",830300,530817,299483,31459,33617,27839
2015,"Bakers",139172,69408,69764,24833,26200,23243
2015,"Butchers and other meat, poultry, and fish processing workers",207420,163796,43624,28372,30533,23870
2015,"Food and tobacco roasting, baking, and drying machine operators and tenders",8298,5909,2389,30587,32077,22152
2015,"Food batchmakers",64716,30666,34050,27198,31260,24809
2015,"Food cooking machine operators and tenders",5350,2975,2375,26943,30690,22426
2015,"Food processing workers, all other",107115,70277,36838,31329,32363,27909
2015,"Computer control programmers and operators",84644,79265,5379,42704,44321,32993
2015,"Extruding and drawing machine setters, operators, and tenders, metal and plastic",10559,9524,1035,38439,38872,30221
2015,"Forging machine setters, operators, and tenders, metal and plastic",7310,6834,476,38750,40165,31984
2015,"Rolling machine setters, operators, and tenders, metal and plastic",8714,6834,1880,45319,46069,36277
2015,"Cutting, punching, and press machine setters, operators, and tenders, metal and plastic",75548,63620,11928,33733,35538,27252
2015,"Drilling and boring machine tool setters, operators, and tenders, metal and plastic",1355,1275,80,38397,40038,28333
2015,"Grinding, lapping, polishing, and buffing machine tool setters, operators, and tenders, metal and plastic",42811,39536,3275,33574,34601,31659
2015,"Lathe and turning machine tool setters, operators, and tenders, metal and plastic",7178,6433,745,37629,40088,27254
2015,"Milling and planing machine setters, operators, and tenders, metal and plastic",1578,1399,179,30927,30942,30864
2015,"Machinists",306776,294514,12262,45930,46405,31772
2015,"Metal furnace operators, tenders, pourers, and casters",21398,19251,2147,41843,42124,39157
2015,"Model makers and patternmakers, metal and plastic",4131,3153,978,45616,50200,22862
2015,"Molders and molding machine setters, operators, and tenders, metal and plastic",34976,30499,4477,36573,37377,32270
2015,"Multiple machine tool setters, operators, and tenders, metal and plastic",3604,3180,424,38750,41765,29745
2015,"Tool and die makers",52096,50184,1912,55475,56431,27805
2015,"Welding, soldering, and brazing workers",514255,489580,24675,40548,40878,30839
2015,"Heat treating equipment setters, operators, and tenders, metal and plastic",5102,4658,444,46967,50127,28353
2015,"Layout workers, metal and plastic",5753,5241,512,43294,45075,39521
2015,"Plating and coating machine setters, operators, and tenders, metal and plastic",14348,13296,1052,35293,34847,41088
2015,"Metal workers and plastic workers, all other",336630,262100,74530,33848,36355,26844
2015,"Prepress technicians and workers",19214,12215,6999,36428,37700,35295
2015,"Printing workers, except prepress technicians and workers",162921,127798,35123,35323,37388,27474
2015,"Laundry and dry-cleaning workers",121900,52495,69405,22331,27141,20277
2015,"Pressers, textile, garment, and related materials",27312,10165,17147,21936,31669,19658
2015,"Sewing machine operators",131070,37666,93404,21839,24565,21306
2015,"Shoe and leather workers and repairers",6640,5357,1283,29370,29059,30127
2015,"Shoe machine operators and tenders",2950,1787,1163,24644,29264,21450
2015,"Tailors, dressmakers, and sewers",43544,12214,31330,25443,32682,23077
2015,"Textile bleaching and dyeing machine operators and tenders",2451,1737,714,31399,30335,35228
2015,"Textile cutting machine setters, operators, and tenders",5925,4512,1413,24248,25278,23010
2015,"Textile knitting and weaving machine setters, operators, and tenders",7156,4143,3013,24854,24779,25041
2015,"Textile winding, twisting, and drawing out machine setters, operators, and tenders",11708,4278,7430,25963,26855,25650
2015,"Fabric and apparel patternmakers",1816,337,1479,58625,32035,70372
2015,"Upholsterers",25446,22552,2894,30621,31151,24594
2015,"Miscellaneous textile, apparel, and furnishings workers, including extruding and forming machine setters, operators, and tenders, synthetic and glass fibers",12398,7625,4773,28159,29200,26210
2015,"Cabinetmakers and bench carpenters",39703,36941,2762,32256,33558,22878
2015,"Furniture finishers",10789,8424,2365,28713,29104,26948
2015,"Sawing machine setters, operators, and tenders, wood",26791,25142,1649,30040,30279,22262
2015,"Woodworking machine setters, operators, and tenders, except sawing",13443,10493,2950,25849,27185,21578
2015,"Miscellaneous woodworkers, including model makers and patternmakers",22696,21232,1464,32156,33192,25679
2015,"Power plant operators, distributors, and dispatchers",45276,42380,2896,90725,90941,84802
2015,"Stationary engineers and boiler operators",81300,78937,2363,56459,56675,50848
2015,"Water and wastewater treatment plant and system operators",74759,69777,4982,50262,50423,45590
2015,"Miscellaneous plant and system operators",42261,39992,2269,61883,62128,60079
2015,"Chemical processing machine setters, operators, and tenders",48836,44149,4687,50240,50363,44090
2015,"Crushing, grinding, polishing, mixing, and blending workers",76006,68607,7399,36668,37187,30257
2015,"Cutting workers",49997,38757,11240,30116,31267,25598
2015,"Extruding, forming, pressing, and compacting machine setters, operators, and tenders",22120,18586,3534,32536,34123,26544
2015,"Furnace, kiln, oven, drier, and kettle operators and tenders",12433,10440,1993,39520,39695,29844
2015,"Inspectors, testers, sorters, samplers, and weighers",643756,417655,226101,41090,46862,32112
2015,"Jewelers and precious stone and metal workers",27793,18918,8875,32094,36175,26355
2015,"Medical, dental, and ophthalmic laboratory technicians",61143,28007,33136,33686,39462,31402
2015,"Packaging and filling machine operators and tenders",199896,93325,106571,25736,29335,23523
2015,"Painting workers",127684,116181,11503,33484,35208,25261
2015,"Photographic process workers and processing machine operators",18581,10055,8526,31876,40222,26546
2015,"Semiconductor processors",2819,1664,1155,43059,62637,32948
2015,"Adhesive bonding machine operators and tenders",6852,4823,2029,35479,39373,27324
2015,"Cleaning, washing, and metal pickling equipment operators and tenders",4471,2917,1554,22363,25339,21754
2015,"Cooling and freezing equipment operators and tenders",2013,1689,324,34580,33088,70515
2015,"Etchers and engravers",7020,4471,2549,30770,32116,30090
2015,"Molders, shapers, and casters, except metal and plastic",24236,21710,2526,31261,31812,26375
2015,"Paper goods machine setters, operators, and tenders",18859,15531,3328,36923,40138,26693
2015,"Tire builders",13082,11555,1527,44488,43854,52037
2015,"Helpers--production workers",28476,22505,5971,27299,30720,20670
2015,"Production workers, all other",1012384,748271,264113,33905,37051,26948
2015,"Transportation and Material Moving Occupations",6498781,5641758,857023,36283,37486,27072
2015,"Transportation Occupations",3927349,3535497,391852,41549,42204,31533
2015,"Supervisors of transportation and material moving workers",191955,152014,39941,50083,51175,40475
2015,"Aircraft pilots and flight engineers",96406,91827,4579,100744,101122,67089
2015,"Air traffic controllers and airfield operations specialists",33438,27537,5901,91165,93508,61448
2015,"Flight attendants",50153,13383,36770,47492,51523,46447
2015,"Ambulance drivers and attendants, except emergency medical technicians",8277,7038,1239,27459,27305,28472
2015,"Bus drivers",288778,174214,114564,32398,38072,27095
2015,"Driver/sales workers and truck drivers",2644153,2526258,117895,41834,42127,30962
2015,"Taxi drivers and chauffeurs",265304,230682,34622,27420,28025,25519
2015,"Motor vehicle operators, all other",19406,17681,1725,26376,26655,23368
2015,"Locomotive engineers and operators",41443,40390,1053,88235,89171,77242
2015,"Railroad brake, signal, and switch operators",4928,4552,376,60761,59383,61895
2015,"Railroad conductors and yardmasters",45382,41828,3554,70810,71385,57074
2015,"Subway, streetcar, and other rail transportation workers",13012,11881,1131,61449,61611,42346
2015,"Sailors and marine oilers",16111,15589,522,50298,50609,30976
2015,"Ship and boat captains and operators",28620,25685,2935,74061,76969,37225
2015,"Parking lot attendants",43949,38026,5923,24167,24822,21547
2015,"Automotive and watercraft service attendants",53855,46788,7067,22502,22632,21986
2015,"Transportation inspectors",41392,36465,4927,54918,57121,36359
2015,"Transportation attendants, except flight attendants",13589,8291,5298,27786,40527,21236
2015,"Other transportation workers",19745,18016,1729,37731,37714,37969
2015,"Material Moving Occupations",2571432,2106261,465171,30254,31092,24835
2015,"Conveyor operators and tenders",4294,3342,952,39835,41020,27883
2015,"Crane and tower operators",53870,52684,1186,60192,60219,51406
2015,"Dredge, excavating, and loading machine operators",27041,26837,204,40540,40613,27024
2015,"Hoist and winch operators",6082,5846,236,47994,48378,19821
2015,"Industrial truck and tractor operators",485176,447589,37587,31800,31772,32105
2015,"Cleaners of vehicles and equipment",224675,195370,29305,24242,24341,23666
2015,"Laborers and freight, stock, and material movers, hand",1331155,1116110,215045,30536,31178,25986
2015,"Machine feeders and offbearers",18459,11194,7265,24902,25841,22075
2015,"Packers and packagers, hand",285020,122856,162164,22713,24795,21675
2015,"Pumping station operators",23091,22340,751,54503,56109,35863
2015,"Refuse and recyclable material collectors",69740,63353,6387,30661,31034,24589
2015,"Material moving workers, all other",37448,33399,4049,36931,37696,31959
2016,"Chief executives",1068258,813898,254360,130266,141108,103564
2016,"General and operations managers",834005,588111,245894,70686,76246,56906
2016,"Legislators",13966,7431,6535,65592,67233,63788
2016,"Advertising and promotions managers",42996,17752,25244,67082,79594,61173
2016,"Marketing and sales managers",843840,464995,378845,82357,100137,69079
2016,"Public relations and fundraising managers",51121,16705,34416,77835,84016,75260
2016,"Administrative services managers",136431,82550,53881,64208,69788,60177
2016,"Computer and information systems managers",564747,413250,151497,103513,107411,95603
2016,"Financial managers",1067163,506068,561095,76178,100505,62089
2016,"Compensation and benefits managers",17074,4254,12820,71605,93895,70251
2016,"Human resources managers",369518,143842,225676,72008,77463,70342
2016,"Training and development managers",49960,23959,26001,72153,82392,64686
2016,"Industrial production managers",220263,176191,44072,76077,77262,70073
2016,"Purchasing managers",181255,94445,86810,76501,82307,70023
2016,"Transportation, storage, and distribution managers",222794,182671,40123,52485,52318,54796
2016,"Farmers, ranchers, and other agricultural managers",451680,400989,50691,41404,42190,30405
2016,"Construction managers",573250,528329,44921,71331,71907,62218
2016,"Education administrators",747962,282062,465900,70748,80380,64509
2016,"Architectural and engineering managers",144812,131956,12856,130293,130300,130255
2016,"Food service managers",792807,436773,356034,38380,42601,31861
2016,"Funeral service managers",5733,4173,1560,60848,60487,61597
2016,"Gaming managers",15477,10129,5348,55674,56664,52872
2016,"Lodging managers",107568,50893,56675,45875,51697,41285
2016,"Medical and health services managers",606615,176012,430603,71739,87311,66855
2016,"Natural sciences managers",17916,8464,9452,92161,111817,76768
2016,"Postmasters and mail superintendents",20947,11398,9549,71429,72401,67745
2016,"Property, real estate, and community association managers",459115,233710,225405,51957,61797,46405
2016,"Social and community service managers",296269,91027,205242,56610,68388,52444
2016,"Emergency management directors",7304,5663,1641,68834,68407,70337
2016,"Managers, all other",3758629,2472383,1286246,78843,84600,67769
2016,"Business and Financial Operations Occupations",6123442,2814981,3308461,63511,74011,56897
2016,"Agents and business managers of artists, performers, and athletes",33337,17328,16009,51728,55328,50761
2016,"Buyers and purchasing agents, farm products",7795,5584,2211,66349,69214,57352
2016,"Wholesale and retail buyers, except farm products",139871,71088,68783,41625,41612,41637
2016,"Purchasing agents, except wholesale, retail, and farm products",253717,122410,131307,54740,60366,51121
2016,"Claims adjusters, appraisers, examiners, and investigators",271129,105531,165598,52582,60840,50024
2016,"Compliance officers",226344,107204,119140,69262,73211,64588
2016,"Cost estimators",122804,105522,17282,63106,65805,49752
2016,"Human resources workers",678049,188438,489611,57369,66412,54975
2016,"Compensation, benefits, and job analysis specialists",47978,10731,37247,54108,62886,51522
2016,"Training and development specialists",111303,50284,61019,58739,65332,52456
2016,"Logisticians",117328,77464,39864,52260,55233,50220
2016,"Management analysts",630863,369877,260986,83080,91169,76338
2016,"Meeting, convention, and event planners",96349,24116,72233,46598,42729,47221
2016,"Fundraisers",68581,20709,47872,66048,77186,64272
2016,"Market research analysts and marketing specialists",237008,103644,133364,70985,82565,64398
2016,"Business operations specialists, all other",236553,110674,125879,61811,73014,52499
2016,"Accountants and auditors",1628824,656553,972271,63740,76129,57370
2016,"Appraisers and assessors of real estate",73690,50409,23281,60533,62298,50291
2016,"Budget analysts",42410,16123,26287,71237,75399,68955
2016,"Credit analysts",26382,12589,13793,53909,58520,51419
2016,"Financial analysts",194932,117808,77124,82415,93203,73427
2016,"Personal financial advisors",327459,231444,96015,91150,101634,69479
2016,"Insurance underwriters",98194,36949,61245,61197,73389,56465
2016,"Financial examiners",14812,7827,6985,79594,85285,70328
2016,"Credit counselors and loan officers",292543,132203,160340,59219,76686,50325
2016,"Tax examiners and collectors, and revenue agents",42395,15901,26494,51797,61586,50296
2016,"Tax preparers",55325,23690,31635,55336,70019,48033
2016,"Financial specialists, all other",47467,22881,24586,61271,85274,50828
2016,"Computer, Engineering, and Science Occupations",7336002,5591448,1744554,80279,82347,70044
2016,"Computer and Mathematical Occupations",3884352,2925768,958584,81760,85427,72472
2016,"Computer and information research scientists",16406,13203,3203,101205,102464,90480
2016,"Computer systems analysts",448325,267043,181282,80219,85192,72409
2016,"Information security analysts",74659,60291,14368,91119,93450,85895
2016,"Computer programmers",370512,293334,77178,85795,87064,80528
2016,"Software developers, applications and systems software",1124661,918865,205796,100760,101969,88759
2016,"Web developers",138048,92611,45437,63173,67356,56860
2016,"Computer support specialists",553718,418848,134870,58027,60363,52699
2016,"Database administrators",99602,62319,37283,81082,90749,60838
2016,"Network and computer systems administrators",192293,157000,35293,73483,74896,69127
2016,"Computer network architects",92872,86504,6368,98374,98123,100471
2016,"Computer occupations, all other",569272,445016,124256,70492,71112,66521
2016,"Actuaries",25197,17769,7428,108576,125465,92500
2016,"Mathematicians",1288,1035,253,121912,130431,81991
2016,"Operations research analysts",126989,63903,63086,81092,85955,76005
2016,"Statisticians",47469,26411,21058,81345,82414,80027
2016,"Miscellaneous mathematical science occupations",3041,1616,1425,66960,85022,46676
2016,"Architecture and Engineering Occupations",2437331,2095090,342241,81125,82192,71072
2016,"Architects, except naval",157568,119954,37614,76154,81075,61765
2016,"Surveyors, cartographers, and photogrammetrists",27429,22619,4810,61119,62390,55812
2016,"Aerospace engineers",114956,102611,12345,102350,104133,91982
2016,"Biomedical engineers",12988,10977,2011,82150,82307,80583
2016,"Chemical engineers",57812,46688,11124,100425,101626,84137
2016,"Civil engineers",311007,271698,39309,86606,89218,75052
2016,"Computer hardware engineers",48767,42855,5912,93870,95911,90712
2016,"Electrical and electronics engineers",186214,171539,14675,96538,98702,81370
2016,"Environmental engineers",27552,19945,7607,80421,81736,75468
2016,"Industrial engineers, including health and safety",183615,145311,38304,79761,80491,75753
2016,"Marine engineers and naval architects",10619,9501,1118,90840,91898,80611
2016,"Materials engineers",34668,31741,2927,81420,81479,80865
2016,"Mechanical engineers",245579,228477,17102,84486,84537,84034
2016,"Mining and geological engineers, including mining safety engineers",8540,7389,1151,93125,95068,92216
2016,"Nuclear engineers",6902,5756,1146,95190,96151,74659
2016,"Petroleum engineers",22671,19383,3288,141359,150247,112500
2016,"Engineers, all other",471817,411849,59968,93058,95214,85464
2016,"Drafters",132332,110629,21703,52899,54290,50363
2016,"Engineering technicians, except drafters",319240,262975,56265,55953,58274,48448
2016,"Surveying and mapping technicians",55079,51382,3697,50071,50231,46731
2016,"Life, Physical, and Social Science Occupations",1014319,570590,443729,65257,70191,60646
2016,"Agricultural and food scientists",21091,13559,7532,70220,71570,64842
2016,"Biological scientists",65111,35893,29218,61171,65122,56853
2016,"Conservation scientists and foresters",18235,14086,4149,60447,60340,60827
2016,"Medical scientists",116550,54653,61897,74534,80827,71175
2016,"Life scientists, all other",4116,2467,1649,65765,81388,54712
2016,"Astronomers and physicists",9881,7669,2212,93935,101448,68105
2016,"Atmospheric and space scientists",10037,8609,1428,90434,91465,84167
2016,"Chemists and materials scientists",77023,49013,28010,70594,75433,63426
2016,"Environmental scientists and geoscientists",63449,42834,20615,72831,79279,60315
2016,"Physical scientists, all other",192236,115118,77118,77439,87134,65913
2016,"Economists",21747,15164,6583,109562,111514,103723
2016,"Survey researchers",1453,423,1030,64230,23794,64931
2016,"Psychologists",121887,37701,84186,72789,90586,69134
2016,"Urban and regional planners",21747,12910,8837,70647,74634,65309
2016,"Miscellaneous social scientists and related workers, including sociologists",24486,12996,11490,61924,67455,57068
2016,"Agricultural and food science technicians",27668,16564,11104,45039,48340,40927
2016,"Biological technicians",16216,8401,7815,49041,50495,44796
2016,"Chemical technicians",56741,40491,16250,52188,54898,48580
2016,"Geological and petroleum technicians",12268,9465,2803,71250,71414,70152
2016,"Nuclear technicians",3432,3144,288,84688,87628,78893
2016,"Social science research assistants",1723,219,1504,41644,50617,41419
2016,"Miscellaneous life, physical, and social science technicians",127222,69211,58011,42673,45323,41614
2016,"Education, Legal, Community Service, Arts, and Media Occupations",10566994,3984993,6582001,50890,59998,47103
2016,"Community and Social Service Occupations",1965931,706430,1259501,44265,45984,42947
2016,"Counselors",536072,148955,387117,45356,46279,45007
2016,"Social workers",704192,133995,570197,44669,44973,44603
2016,"Probation officers and correctional treatment specialists",81680,37849,43831,48545,48620,48480
2016,"Social and human service assistants",146414,32813,113601,37732,39459,37450
2016,"Miscellaneous community and social service specialists, including health educators and community health workers",63963,21744,42219,45512,49319,42490
2016,"Clergy",347581,291732,55849,45502,46282,41571
2016,"Directors, religious activities and education",45090,20243,24847,44160,51925,40845
2016,"Religious workers, all other",40939,19099,21840,35551,37461,32408
2016,"Legal Occupations",1405105,682419,722686,86747,121654,65014
2016,"Lawyers",891088,568630,322458,122073,136043,102484
2016,"Judicial law clerks",10323,3490,6833,55882,56766,52494
2016,"Judges, magistrates, and other judicial workers",58544,32986,25558,102861,125071,80807
2016,"Paralegals and legal assistants",318793,43287,275506,47223,49198,47073
2016,"Miscellaneous legal support workers",126357,34026,92331,50997,66459,46470
2016,"Education, Training, and Library Occupations",5348821,1547041,3801780,49619,56876,46403
2016,"Postsecondary teachers",881345,470888,410457,67145,74485,61169
2016,"Preschool and kindergarten teachers",339677,6755,332922,25124,29102,25021
2016,"Elementary and middle school teachers",2398445,530970,1867475,50659,53096,50021
2016,"Secondary school teachers",536264,231158,305106,52671,55800,51608
2016,"Special education teachers",178054,25632,152422,48840,49953,48703
2016,"Other teachers and instructors",356475,167249,189226,45426,51439,40544
2016,"Archivists, curators, and museum technicians",36260,13889,22371,48374,52835,45296
2016,"Librarians",115076,23238,91838,51429,57961,50671
2016,"Library technicians",11386,2235,9151,31228,45951,28397
2016,"Teacher assistants",421376,53389,367987,22682,31063,22095
2016,"Other education, training, and library workers",74463,21638,52825,52790,59582,51638
2016,"Arts, Design, Entertainment, Sports, and Media Occupations",1847137,1049103,798034,51760,55625,48440
2016,"Artists and related workers",121771,76519,45252,45124,51669,36922
2016,"Designers",628865,328481,300384,51768,60035,46516
2016,"Actors",14423,8254,6169,41201,43425,36214
2016,"Producers and directors",121999,77794,44205,68571,71577,62435
2016,"Athletes, coaches, umpires, and related workers",123505,91380,32125,46393,49152,41270
2016,"Dancers and choreographers",6556,1468,5088,31342,51586,24844
2016,"Musicians, singers, and related workers",66779,51875,14904,41300,41521,40399
2016,"Entertainers and performers, sports and related workers, all other",18325,11738,6587,39303,41549,31670
2016,"Announcers",26152,19879,6273,45767,45883,45062
2016,"News analysts, reporters and correspondents",57202,31972,25230,55372,58457,50435
2016,"Public relations specialists",103540,35880,67660,65386,77116,61547
2016,"Editors",125387,64120,61267,55140,57665,52078
2016,"Technical writers",47360,19792,27568,71388,73800,70139
2016,"Writers and authors",132235,57364,74871,55464,58065,52347
2016,"Miscellaneous media and communication workers",54009,20909,33100,42255,47608,41197
2016,"Miscellaneous media and communications equipment workers, including broadcast and sound engineering technicians and radio operators",70806,66356,4450,52335,54586,46794
2016,"Photographers",90481,54402,36079,36504,41275,31254
2016,"Television, video, and motion picture camera operators and editors",37742,30920,6822,51138,51388,50355
2016,"Healthcare Practitioners and Technical Occupations",6558946,1806655,4752291,61813,81023,58404
2016,"Chiropractors",40960,31857,9103,80466,86586,57522
2016,"Dentists",93294,65998,27296,150132,158810,115473
2016,"Dietitians and nutritionists",70729,8095,62634,49841,47439,49886
2016,"Optometrists",27134,18087,9047,117397,125489,101000
2016,"Pharmacists",214665,97539,117126,120878,122351,118461
2016,"Physicians and surgeons",743383,489748,253635,201542,231420,166388
2016,"Physician assistants",76018,27869,48149,101940,111673,100434
2016,"Podiatrists",6093,5140,953,126617,140350,101644
2016,"Audiologists",11195,2186,9009,72760,74127,72123
2016,"Occupational therapists",72099,9813,62286,70679,80834,70044
2016,"Physical therapists",162536,60163,102373,77605,85149,74555
2016,"Radiation therapists",10165,3289,6876,88073,95008,79488
2016,"Recreational therapists",10160,3072,7088,40040,41037,38967
2016,"Respiratory therapists",92125,37338,54787,56532,61280,52583
2016,"Speech-language pathologists",87443,4661,82782,63532,75360,62734
2016,"Miscellaneous therapists, including exercise physiologists",107797,25250,82547,50208,52202,48955
2016,"Veterinarians",65797,26912,38885,90063,103622,82228
2016,"Registered nurses",2317493,281048,2036445,65331,70952,64413
2016,"Nurse anesthetists",26253,10941,15312,160522,176957,151667
2016,"Nurse practitioners",116166,14128,102038,100639,111130,100030
2016,"Health diagnosing and treating practitioners, all other",13264,5463,7801,55718,65898,51087
2016,"Clinical laboratory technologists and technicians",245278,68887,176391,48170,51112,46984
2016,"Dental hygienists",71498,4845,66653,56632,70807,55946
2016,"Diagnostic related technologists and technicians",263276,88369,174907,58828,64560,55958
2016,"Emergency medical technicians and paramedics",167315,114281,53034,42373,46301,39941
2016,"Health practitioner support technologists and technicians",440607,98824,341783,32466,36093,32093
2016,"Licensed practical and licensed vocational nurses",602316,77484,524832,38946,40939,38523
2016,"Medical records and health information technicians",148302,14938,133364,38273,37208,38404
2016,"Opticians, dispensing",48366,14044,34322,37389,50622,35058
2016,"Miscellaneous health technologists and technicians",97277,36999,60278,41207,51118,36438
2016,"Other healthcare practitioners and technical occupations",105941,59387,46554,57179,61968,52594
2016,"Healthcare Support Occupations",2205309,320622,1884687,28085,31269,27470
2016,"Nursing, psychiatric, and home health aides",1256050,174528,1081522,26056,29503,25706
2016,"Occupational therapy assistants and aides",13820,2179,11641,51182,60709,49665
2016,"Physical therapist assistants and aides",59281,19380,39901,45826,48915,42677
2016,"Massage therapists",67798,16699,51099,30766,30833,30739
2016,"Dental assistants",167955,13096,154859,31226,32231,31161
2016,"Medical assistants",382920,35341,347579,30549,32083,30418
2016,"Medical transcriptionists",20559,1615,18944,33597,40995,33161
2016,"Pharmacy aides",21617,5064,16553,30505,36481,29651
2016,"Veterinary assistants and laboratory animal caretakers",28193,6400,21793,26441,35501,25095
2016,"Phlebotomists",82446,12560,69886,31121,30925,31160
2016,"Healthcare support workers, all other, including medical equipment preparers",104670,33760,70910,30124,31812,28592
2016,"Protective Service Occupations",2516945,2036431,480514,50773,52217,41504
2016,"First-line supervisors of correctional officers",55565,39893,15672,51570,53611,48621
2016,"First-line supervisors of police and detectives",100335,84933,15402,79259,81092,70191
2016,"First-line supervisors of fire fighting and prevention workers",44941,43233,1708,90571,90912,85270
2016,"First-line supervisors of protective service workers, all other",66575,49742,16833,49305,46609,54717
2016,"Firefighters",265198,253361,11837,67598,68680,51926
2016,"Fire inspectors",19259,17157,2102,60006,60447,51104
2016,"Bailiffs, correctional officers, and jailers",375720,277833,97887,44807,47005,39834
2016,"Detectives and criminal investigators",112869,85853,27016,76604,81253,61821
2016,"Fish and game wardens",4716,3820,896,52265,55234,47351
2016,"Parking enforcement workers",4730,2329,2401,39298,41625,38221
2016,"Police and sheriff patrol officers",669550,582716,86834,62852,64792,57402
2016,"Animal control workers",9987,5824,4163,33303,34833,32219
2016,"Private detectives and investigators",70181,38879,31302,56272,61192,49673
2016,"Security guards and gaming surveillance officers",647922,505565,142357,30422,30724,28889
2016,"Crossing guards",10864,6311,4553,32538,31130,36219
2016,"Transportation security screeners",33438,22782,10656,41793,43027,40534
2016,"Lifeguards and other recreational, and all other protective service workers",24348,15453,8895,30979,36282,21087
2016,"Food Preparation and Serving Related Occupations",3769365,2027036,1742329,22544,24935,21224
2016,"Chefs and head cooks",346683,276631,70052,31461,32240,27651
2016,"First-line supervisors of food preparation and serving workers",409285,190025,219260,25713,29657,22979
2016,"Cooks",1201892,775087,426805,21756,22575,20320
2016,"Food preparation workers",347692,155856,191836,20506,21359,19894
2016,"Bartenders",226847,115120,111727,29375,31277,26017
2016,"Combined food preparation and serving workers, including fast food",141425,52096,89329,20518,20728,20369
2016,"Counter attendants, cafeteria, food concession, and coffee shop",32438,12016,20422,19179,21885,17398
2016,"Waiters and waitresses",734635,263439,471196,22252,25855,21182
2016,"Food servers, nonrestaurant",76030,28696,47334,24489,27481,23021
2016,"Dining room and cafeteria attendants and bartender helpers",91150,56105,35045,21276,22449,18832
2016,"Dishwashers",110513,91810,18703,19808,19848,19550
2016,"Hosts and hostesses, restaurant, lounge, and coffee shop",46117,7311,38806,19751,22335,19022
2016,"Food preparation and serving related workers, all other",4658,2844,1814,20199,20559,19202
2016,"Building and Grounds Cleaning and Maintenance Occupations",3516387,2331552,1184835,26420,30043,21933
2016,"First-line supervisors of housekeeping and janitorial workers",173482,117566,55916,36399,41024,28875
2016,"First-line supervisors of landscaping, lawn service, and groundskeeping workers",128673,121311,7362,40635,40774,36184
2016,"Janitors and building cleaners",1553626,1136790,416836,27742,30654,22962
2016,"Maids and housekeeping cleaners",790133,128212,661921,21476,25788,21000
2016,"Pest control workers",68409,65344,3065,37802,37805,37420
2016,"Grounds maintenance workers",802064,762329,39735,25708,25838,22944
2016,"Personal Care and Service Occupations",2738373,681749,2056624,25119,30831,23318
2016,"First-line supervisors of gaming workers",18772,11389,7383,45671,50429,41069
2016,"First-line supervisors of personal service workers",74093,25605,48488,32240,41425,30569
2016,"Animal trainers",29055,14018,15037,29978,34134,26578
2016,"Nonfarm animal caretakers",120981,34640,86341,25210,30133,23724
2016,"Gaming services workers",61881,34548,27333,39726,41137,36013
2016,"Motion picture projectionists",1303,1065,238,48374,49900,21932
2016,"Ushers, lobby attendants, and ticket takers",6511,3855,2656,28929,30020,27430
2016,"Miscellaneous entertainment attendants and related workers",57391,31464,25927,25263,27418,21946
2016,"Embalmers and funeral attendants",6580,5293,1287,29048,28629,29681
2016,"Morticians, undertakers, and funeral directors",30549,22471,8078,51310,52119,42161
2016,"Barbers",68864,56579,12285,25416,26320,21195
2016,"Hairdressers, hairstylists, and cosmetologists",447533,52211,395322,26146,31601,25636
2016,"Miscellaneous personal appearance workers",206248,34993,171255,23474,26356,22777
2016,"Baggage porters, bellhops, and concierges",60412,47690,12722,31604,33549,27122
2016,"Tour and travel guides",18870,11893,6977,30693,31305,29836
2016,"Childcare workers",551286,34354,516932,21395,25324,21212
2016,"Personal care aides",692735,132541,560194,22578,25856,22159
2016,"Recreation and fitness workers",184743,79514,105229,31582,35050,30284
2016,"Residential advisors",26803,10295,16508,28627,30144,27901
2016,"Personal care and service workers, all other",73763,37331,36432,26185,27148,24883
2016,"Sales and Related Occupations",10085935,5907517,4178418,43647,51791,34226
2016,"First-line supervisors of retail sales workers",2677578,1537529,1140049,40573,46343,33778
2016,"First-line supervisors of non-retail sales workers",1074798,748785,326013,65016,67434,58166
2016,"Cashiers",1019364,293166,726198,21000,22413,20482
2016,"Counter and rental clerks",52412,30604,21808,31285,35907,25780
2016,"Parts salespersons",92199,83465,8734,35832,36526,30509
2016,"Retail salespersons",1716984,1047929,669055,32480,40116,26781
2016,"Advertising sales agents",148263,72790,75473,61018,66149,56104
2016,"Insurance sales agents",442385,232516,209869,51364,62412,42316
2016,"Securities, commodities, and financial services sales agents",199539,142840,56699,91885,115432,58726
2016,"Travel agents",49901,11210,38691,41744,46173,40707
2016,"Sales representatives, services, all other",534512,368392,166120,66475,71706,56236
2016,"Sales representatives, wholesale and manufacturing",1182664,878257,304407,65716,70464,54077
2016,"Models, demonstrators, and product promoters",12940,4816,8124,31463,42193,28908
2016,"Real estate brokers and sales agents",576380,278623,297757,57486,69512,50662
2016,"Sales engineers",35706,33085,2621,111522,113110,80101
2016,"Telemarketers",41866,16569,25297,25732,27152,25125
2016,"Door-to-door sales workers, news and street vendors, and related workers",49513,25691,23822,30475,35417,25753
2016,"Sales and related workers, all other",178931,101250,77681,54472,61262,48884
2016,"Office and Administrative Support Occupations",13475419,3953161,9522258,36290,40053,35548
2016,"First-line supervisors of office and administrative support workers",1187429,479925,707504,50070,56346,45996
2016,"Switchboard operators, including answering service",17734,3612,14122,30456,32279,29428
2016,"Telephone operators",24570,7004,17566,31443,36713,30077
2016,"Communications equipment operators, all other",6802,2751,4051,43269,57401,36789
2016,"Bill and account collectors",123438,35970,87468,35448,38514,34145
2016,"Billing and posting clerks",396298,45845,350453,35026,39843,34424
2016,"Bookkeeping, accounting, and auditing clerks",829531,105920,723611,39329,42013,38665
2016,"Gaming cage workers",7661,2566,5095,29747,30445,29454
2016,"Payroll and timekeeping clerks",131052,16608,114444,41313,49112,40922
2016,"Procurement clerks",29591,13472,16119,56309,60750,51406
2016,"Tellers",211343,28579,182764,26405,26674,26361
2016,"Financial clerks, all other",102650,47844,54806,55627,80037,45021
2016,"Brokerage clerks",5600,1925,3675,47489,55744,46240
2016,"Correspondence clerks",3925,1603,2322,48989,45353,50434
2016,"Court, municipal, and license clerks",62021,12876,49145,38317,45566,37355
2016,"Credit authorizers, checkers, and clerks",30897,8454,22443,41698,51812,40120
2016,"Customer service representatives",1782634,624476,1158158,33442,36744,32095
2016,"Eligibility interviewers, government programs",73673,14480,59193,41945,49343,41024
2016,"File clerks",137412,30743,106669,34159,36584,33224
2016,"Hotel, motel, and resort desk clerks",85672,28143,57529,22230,24328,21575
2016,"Interviewers, except eligibility and loan",85914,14408,71506,31905,40750,31371
2016,"Library assistants, clerical",32411,5476,26935,30777,30821,30768
2016,"Loan interviewers and clerks",111389,21075,90314,41419,45018,41065
2016,"New accounts clerks",11515,3187,8328,35639,41611,32278
2016,"Order clerks",97111,46722,50389,32234,35154,31110
2016,"Human resources assistants, except payroll and timekeeping",41036,6446,34590,39336,42269,38544
2016,"Receptionists and information clerks",654662,62554,592108,28555,29582,28444
2016,"Reservation and transportation ticket agents and travel clerks",95666,40719,54947,38473,41701,36670
2016,"Information and record clerks, all other",78023,18649,59374,37235,41564,36385
2016,"Cargo and freight agents",18080,12010,6070,39230,40883,34028
2016,"Couriers and messengers",141348,118900,22448,37585,39751,31910
2016,"Dispatchers",246262,114123,132139,38780,41998,35987
2016,"Meter readers, utilities",22784,20083,2701,40726,41069,36016
2016,"Postal service clerks",97883,48811,49072,55378,56060,53272
2016,"Postal service mail carriers",281178,179493,101685,56755,58358,53337
2016,"Postal service mail sorters, processors, and processing machine operators",50704,25280,25424,54397,56107,51252
2016,"Production, planning, and expediting clerks",283387,121074,162313,48582,61813,40678
2016,"Shipping, receiving, and traffic clerks",475270,338248,137022,31175,31887,28869
2016,"Stock clerks and order fillers",905020,602176,302844,27212,27445,26749
2016,"Weighers, measurers, checkers, and samplers, recordkeeping",58258,30597,27661,35545,37906,31956
2016,"Secretaries and administrative assistants",2226591,118739,2107852,37122,42411,36929
2016,"Computer operators",75141,41335,33806,42199,51176,38041
2016,"Data entry keyers",218791,51255,167536,32441,35201,32168
2016,"Word processors and typists",198318,31601,166717,34645,38353,33909
2016,"Desktop publishers",1413,878,535,38949,43391,32024
2016,"Insurance claims and policy processing clerks",325075,63360,261715,37301,40881,36812
2016,"Mail clerks and mail machine operators, except postal service",53499,27874,25625,29624,31777,26983
2016,"Office clerks, general",841347,145063,696284,34654,39885,33492
2016,"Office machine operators, except computer",26251,9726,16525,30788,37057,28449
2016,"Proofreaders and copy markers",6113,2139,3974,40435,38538,41357
2016,"Statistical assistants",15243,6858,8385,50405,52172,47920
2016,"Office and administrative support workers, all other",449803,111506,338297,41080,46448,40209
2016,"Natural Resources, Construction, and Maintenance Occupations",10336235,9943126,393109,41407,41612,31194
2016,"Farming, Fishing, and Forestry Occupations",644116,533883,110233,26661,28231,21214
2016,"First-line supervisors of farming, fishing, and forestry workers",50964,44390,6574,41273,42138,31416
2016,"Agricultural inspectors",12725,7187,5538,49889,47000,52455
2016,"Animal breeders",3290,2273,1017,30110,36109,27743
2016,"Graders and sorters, agricultural products",32820,11478,21342,21235,22957,20791
2016,"Miscellaneous agricultural workers",470635,398935,71700,25442,26404,20399
2016,"Fishing and hunting workers",21825,20865,960,31986,32200,25595
2016,"Forest and conservation workers",9824,8377,1447,36088,37410,29661
2016,"Logging workers",42033,40378,1655,32394,33045,21427
2016,"Construction and Extraction Occupations",5684325,5535847,148478,40852,40926,35859
2016,"First-line supervisors of construction trades and extraction workers",670638,649980,20658,59536,60145,45174
2016,"Brickmasons, blockmasons, and stonemasons",98752,98324,428,33569,33437,52637
2016,"Carpenters",863456,846846,16610,36344,36414,31637
2016,"Carpet, floor, and tile installers and finishers",115722,113490,2232,34531,34773,30610
2016,"Construction laborers",1180144,1150257,29887,32162,32214,30378
2016,"Paving, surfacing, and tamping equipment operators",11253,10740,513,41825,42075,40967
2016,"Operating engineers and other construction equipment operators, including pile-driver operators",269313,262747,6566,46503,46485,50129
2016,"Drywall installers, ceiling tile installers, and tapers",97916,95903,2013,31344,31450,21351
2016,"Electricians",647922,635090,12832,51278,51289,50082
2016,"Glaziers",37172,37023,149,40202,40196,41583
2016,"Insulation workers",39022,37762,1260,36329,36411,32216
2016,"Painters, construction and maintenance",359202,342580,16622,30778,30840,28608
2016,"Paperhangers",2130,1494,636,39968,51503,30208
2016,"Pipelayers, plumbers, pipefitters, and steamfitters",478329,470850,7479,47032,47046,45525
2016,"Plasterers and stucco masons",22350,22059,291,31073,31084,30701
2016,"Roofers",143180,141632,1548,30330,30268,50141
2016,"Sheet metal workers",97860,93784,4076,41644,41844,31804
2016,"Structural iron and steel workers",45672,44643,1029,50902,50571,70904
2016,"Helpers, construction trades",26342,25104,1238,26554,26378,31607
2016,"Construction and building inspectors",74917,66256,8661,56109,57669,50025
2016,"Elevator installers and repairers",22574,22119,455,84181,85281,41783
2016,"Fence erectors",22014,21176,838,30844,30985,22235
2016,"Hazardous materials removal workers",23647,19634,4013,36733,40524,22296
2016,"Highway maintenance workers",84345,81531,2814,39354,39654,31523
2016,"Rail-track laying and maintenance equipment operators",10530,10221,309,56883,58917,50596
2016,"Septic tank servicers and sewer pipe cleaners",9144,8970,174,41736,41925,16726
2016,"Miscellaneous construction and related workers, including solar photovoltaic installers",44893,42825,2068,35661,35573,36556
2016,"Derrick, rotary drill, and service unit operators, oil, gas, and mining",15635,15545,90,70098,70027,158929
2016,"Explosives workers, ordnance handling experts, and blasters",9819,8893,926,54454,51456,66068
2016,"Mining machine operators",41476,41142,334,66863,66715,91628
2016,"Other extraction workers",37639,36346,1293,54426,55503,26987
2016,"Installation, Maintenance, and Repair Occupations",4007794,3873396,134398,45939,46092,40827
2016,"First-line supervisors of mechanics, installers, and repairers",245683,228738,16945,60447,60653,52313
2016,"Computer, automated teller, and office machine repairers",145593,129949,15644,43661,43659,43673
2016,"Radio and telecommunications equipment installers and repairers",138322,125899,12423,52338,52854,43442
2016,"Avionics technicians",14223,12971,1252,53595,55164,41295
2016,"Electric motor, power tool, and related repairers",19319,18438,881,45532,46449,21283
2016,"Electrical and electronics repairers, industrial and utility",11642,11189,453,61825,62348,34616
2016,"Electronic equipment installers and repairers, motor vehicles",6365,6247,118,33643,33363,43438
2016,"Electronic home entertainment equipment installers and repairers",30552,29243,1309,41409,41809,31886
2016,"Security and fire alarm systems installers",55556,54344,1212,42132,42195,32085
2016,"Aircraft mechanics and service technicians",135682,129265,6417,61530,61757,52219
2016,"Automotive body and related repairers",119554,117442,2112,40841,40984,21989
2016,"Automotive glass installers and repairers",13994,13660,334,36565,36680,31938
2016,"Automotive service technicians and mechanics",726437,717661,8776,36634,36695,28342
2016,"Bus and truck mechanics and diesel engine specialists",274372,271606,2766,45320,45423,35206
2016,"Heavy vehicle and mobile equipment service technicians and mechanics",185817,183026,2791,51142,51192,36781
2016,"Small engine mechanics",33288,32974,314,32818,32920,30427
2016,"Miscellaneous vehicle and mobile equipment mechanics, installers, and repairers",59830,58748,1082,30297,30233,31652
2016,"Control and valve installers and repairers",16320,15687,633,52039,52281,40096
2016,"Heating, air conditioning, and refrigeration mechanics and installers",328423,323520,4903,45440,45558,36241
2016,"Home appliance repairers",29270,27938,1332,38745,39861,21141
2016,"Industrial and refractory machinery mechanics",350416,339183,11233,51050,51187,43169
2016,"Maintenance and repair workers, general",438171,426084,12087,44573,45007,35977
2016,"Maintenance workers, machinery",26300,24982,1318,48447,49195,36327
2016,"Millwrights",37285,36664,621,61877,62133,47123
2016,"Electrical power-line installers and repairers",106191,105150,1041,70012,70154,41238
2016,"Telecommunications line installers and repairers",125604,120639,4965,50164,49989,56978
2016,"Precision instrument and equipment repairers",47211,42058,5153,51655,53697,38147
2016,"Coin, vending, and amusement machine servicers and repairers",26515,23061,3454,36449,37557,28092
2016,"Locksmiths and safe repairers",20462,19179,1283,42329,44176,31038
2016,"Riggers",10169,10034,135,49346,50086,31276
2016,"Helpers--installation, maintenance, and repair workers",12046,11641,405,31302,31076,35351
2016,"Other installation, maintenance, and repair workers, including wind turbine service technicians",204755,194046,10709,40529,40789,34637
2016,"Production Occupations",7084690,5206127,1878563,36773,40898,28241
2016,"First-line supervisors of production and operating workers",836803,677383,159420,52520,56343,41397
2016,"Aircraft structure, surfaces, rigging, and systems assemblers",5359,4399,960,46687,50047,31082
2016,"Electrical, electronics, and electromechanical assemblers",105464,53762,51702,31438,34772,29682
2016,"Engine and other machine assemblers",11383,9632,1751,45794,50418,29740
2016,"Structural metal fabricators and fitters",23431,22602,829,43039,42896,45391
2016,"Miscellaneous assemblers and fabricators",811317,511277,300040,31485,33412,28313
2016,"Bakers",148282,68168,80114,25848,26896,24665
2016,"Butchers and other meat, poultry, and fish processing workers",202694,159194,43500,29474,30898,25313
2016,"Food and tobacco roasting, baking, and drying machine operators and tenders",8787,6425,2362,29654,31168,26246
2016,"Food batchmakers",63244,28012,35232,27101,31939,25315
2016,"Food cooking machine operators and tenders",6230,3118,3112,26528,31345,19516
2016,"Food processing workers, all other",113094,74917,38177,31967,34446,29998
2016,"Computer control programmers and operators",84907,77415,7492,44235,45373,35785
2016,"Extruding and drawing machine setters, operators, and tenders, metal and plastic",12248,10632,1616,36047,36243,33269
2016,"Forging machine setters, operators, and tenders, metal and plastic",6023,5882,141,45387,45495,40659
2016,"Rolling machine setters, operators, and tenders, metal and plastic",8890,6446,2444,35268,41292,31361
2016,"Cutting, punching, and press machine setters, operators, and tenders, metal and plastic",73711,61267,12444,32249,33096,29971
2016,"Drilling and boring machine tool setters, operators, and tenders, metal and plastic",4257,3563,694,40872,46574,25953
2016,"Grinding, lapping, polishing, and buffing machine tool setters, operators, and tenders, metal and plastic",38492,34722,3770,32512,33540,26940
2016,"Lathe and turning machine tool setters, operators, and tenders, metal and plastic",8021,7150,871,37408,40042,32740
2016,"Milling and planing machine setters, operators, and tenders, metal and plastic",1798,1510,288,37477,43523,11674
2016,"Machinists",297165,284315,12850,46666,47139,32065
2016,"Metal furnace operators, tenders, pourers, and casters",20923,18354,2569,43427,45277,31818
2016,"Model makers and patternmakers, metal and plastic",4276,3680,596,49469,49528,44894
2016,"Molders and molding machine setters, operators, and tenders, metal and plastic",33959,28251,5708,35532,37402,29056
2016,"Multiple machine tool setters, operators, and tenders, metal and plastic",2097,1884,213,47536,50644,46329
2016,"Tool and die makers",50267,49521,746,55390,55465,48137
2016,"Welding, soldering, and brazing workers",475547,449552,25995,40394,40770,31097
2016,"Heat treating equipment setters, operators, and tenders, metal and plastic",6474,6135,339,44329,45883,24395
2016,"Layout workers, metal and plastic",5546,4862,684,51240,52147,46871
2016,"Plating and coating machine setters, operators, and tenders, metal and plastic",12839,11669,1170,32560,33452,31061
2016,"Tool grinders, filers, and sharpeners",5015,4845,170,44996,45398,30923
2016,"Metal workers and plastic workers, all other",326498,258055,68443,35076,36748,29096
2016,"Prepress technicians and workers",17187,9888,7299,36257,41563,30647
2016,"Printing workers, except prepress technicians and workers",157832,125189,32643,37214,40598,28722
2016,"Laundry and dry-cleaning workers",116109,46921,69188,22823,26697,21245
2016,"Pressers, textile, garment, and related materials",24529,10530,13999,21308,26667,19094
2016,"Sewing machine operators",129635,38708,90927,23027,25189,22358
2016,"Shoe and leather workers and repairers",8294,6063,2231,26559,27021,25825
2016,"Shoe machine operators and tenders",2149,766,1383,23349,25646,20446
2016,"Tailors, dressmakers, and sewers",38822,11704,27118,26152,36186,23975
2016,"Textile bleaching and dyeing machine operators and tenders",1234,849,385,26938,30574,23655
2016,"Textile cutting machine setters, operators, and tenders",6067,3153,2914,22483,24093,21768
2016,"Textile knitting and weaving machine setters, operators, and tenders",7421,3616,3805,28490,30297,27888
2016,"Textile winding, twisting, and drawing out machine setters, operators, and tenders",9640,3818,5822,26440,27864,25962
2016,"Fabric and apparel patternmakers",2114,368,1746,61630,66227,61097
2016,"Upholsterers",23251,19562,3689,33082,35421,29958
2016,"Miscellaneous textile, apparel, and furnishings workers, including extruding and forming machine setters, operators, and tenders, synthetic and glass fibers",12112,7106,5006,31173,33827,28770
2016,"Cabinetmakers and bench carpenters",44283,41443,2840,35113,36097,27509
2016,"Furniture finishers",7973,6435,1538,31457,34727,21619
2016,"Sawing machine setters, operators, and tenders, wood",25859,22926,2933,27707,28859,23684
2016,"Woodworking machine setters, operators, and tenders, except sawing",15419,12322,3097,27718,30243,24063
2016,"Miscellaneous woodworkers, including model makers and patternmakers",22665,20666,1999,32046,32052,31993
2016,"Power plant operators, distributors, and dispatchers",42662,39345,3317,89417,90326,72348
2016,"Stationary engineers and boiler operators",80093,78076,2017,60018,60049,52121
2016,"Water and wastewater treatment plant and system operators",78358,75104,3254,48818,49659,40614
2016,"Miscellaneous plant and system operators",37531,35295,2236,63780,64776,54020
2016,"Chemical processing machine setters, operators, and tenders",48578,43856,4722,51853,51737,54830
2016,"Crushing, grinding, polishing, mixing, and blending workers",66068,57898,8170,37087,38136,29582
2016,"Cutting workers",51485,41676,9809,30780,31798,26199
2016,"Extruding, forming, pressing, and compacting machine setters, operators, and tenders",23961,20153,3808,36321,38619,24726
2016,"Furnace, kiln, oven, drier, and kettle operators and tenders",10409,8744,1665,42352,45284,36547
2016,"Inspectors, testers, sorters, samplers, and weighers",666282,414113,252169,41029,47048,32183
2016,"Jewelers and precious stone and metal workers",25368,17016,8352,32523,40173,25842
2016,"Medical, dental, and ophthalmic laboratory technicians",58471,30351,28120,36146,41304,32104
2016,"Packaging and filling machine operators and tenders",204703,94628,110075,27178,31391,24791
2016,"Painting workers",126596,111321,15275,36898,39257,26885
2016,"Photographic process workers and processing machine operators",17651,9662,7989,31397,37525,26314
2016,"Semiconductor processors",1741,1203,538,36791,36050,41018
2016,"Adhesive bonding machine operators and tenders",6765,3859,2906,26961,36218,19670
2016,"Cleaning, washing, and metal pickling equipment operators and tenders",3785,2887,898,31971,33674,25705
2016,"Cooling and freezing equipment operators and tenders",2374,2071,303,47469,48516,33696
2016,"Etchers and engravers",8059,6017,2042,32736,35017,31354
2016,"Molders, shapers, and casters, except metal and plastic",22330,19527,2803,32017,33234,25597
2016,"Paper goods machine setters, operators, and tenders",24020,17945,6075,38661,42381,26883
2016,"Tire builders",12530,11501,1029,41969,41952,45525
2016,"Helpers--production workers",23695,19206,4489,28256,30140,25318
2016,"Production workers, all other",953539,704041,249498,35030,37414,27236
2016,"Transportation and Material Moving Occupations",6605581,5722980,882601,36644,38520,27349
2016,"Transportation Occupations",4017489,3621746,395743,41788,42389,31991
2016,"Supervisors of transportation and material moving workers",196226,156914,39312,51318,53614,40710
2016,"Aircraft pilots and flight engineers",102512,96231,6281,102155,102479,90665
2016,"Air traffic controllers and airfield operations specialists",29978,24679,5299,90935,92499,72322
2016,"Flight attendants",53686,15733,37953,48586,59579,42869
2016,"Ambulance drivers and attendants, except emergency medical technicians",10405,8616,1789,28239,28017,30258
2016,"Bus drivers",280228,178493,101735,35222,38539,29570
2016,"Driver/sales workers and truck drivers",2695081,2570385,124696,42200,42435,32237
2016,"Taxi drivers and chauffeurs",302027,265426,36601,27925,29130,25365
2016,"Motor vehicle operators, all other",17956,15257,2699,30386,30781,24567
2016,"Locomotive engineers and operators",43277,41071,2206,85678,85978,80335
2016,"Railroad conductors and yardmasters",43761,41145,2616,71955,72667,58522
2016,"Subway, streetcar, and other rail transportation workers",14379,12538,1841,66028,66705,50528
2016,"Sailors and marine oilers",15230,13658,1572,47279,47363,37364
2016,"Ship and boat captains and operators",24058,22985,1073,73064,74068,60630
2016,"Bridge and lock tenders",3937,3590,347,52388,53088,46458
2016,"Parking lot attendants",46169,40140,6029,23264,23580,22742
2016,"Automotive and watercraft service attendants",59150,52107,7043,23322,23813,21091
2016,"Transportation inspectors",39784,34774,5010,60174,61564,40751
2016,"Transportation attendants, except flight attendants",15697,7554,8143,29067,36822,26206
2016,"Other transportation workers",17369,14420,2949,36282,38674,27308
2016,"Material Moving Occupations",2588092,2101234,486858,30616,31564,25006
2016,"Conveyor operators and tenders",4427,3447,980,36974,38235,30806
2016,"Crane and tower operators",53751,52233,1518,58290,58643,40682
2016,"Dredge, excavating, and loading machine operators",27092,26712,380,42058,42289,31116
2016,"Industrial truck and tractor operators",501490,465444,36046,32303,32305,32272
2016,"Cleaners of vehicles and equipment",225496,192986,32510,25839,26267,22073
2016,"Laborers and freight, stock, and material movers, hand",1340831,1107839,232992,30729,31424,26312
2016,"Machine feeders and offbearers",15745,9103,6642,29485,32497,22554
2016,"Packers and packagers, hand",292614,128616,163998,23676,26211,22013
2016,"Pumping station operators",19540,18917,623,62096,62053,67083
2016,"Refuse and recyclable material collectors",65170,58851,6319,32367,34488,24268
2016,"Material moving workers, all other",31072,26478,4594,35716,36013,31922
2017,"Chief executives",1098048,831158,266890,134656,148867,111236
2017,"General and operations managers",885352,620422,264930,71533,76691,61202
2017,"Legislators",11439,7939,3500,68858,76602,55574
2017,"Advertising and promotions managers",41608,19269,22339,66733,72262,61235
2017,"Marketing and sales managers",863652,479654,383998,85215,100288,71066
2017,"Public relations and fundraising managers",53176,19181,33995,81959,90827,77994
2017,"Administrative services managers",133284,86878,46406,65947,69102,61453
2017,"Computer and information systems managers",561466,401470,159996,103412,109674,95341
2017,"Financial managers",1066848,512744,554104,80144,100575,65237
2017,"Compensation and benefits managers",16470,4547,11923,76472,81246,71026
2017,"Human resources managers",377342,148568,228774,74586,81443,71039
2017,"Training and development managers",53382,24837,28545,75225,77351,71730
2017,"Industrial production managers",233451,185795,47656,78170,81041,69873
2017,"Purchasing managers",185381,96847,88534,76988,81607,72359
2017,"Transportation, storage, and distribution managers",221952,182380,39572,53212,53629,51660
2017,"Farmers, ranchers, and other agricultural managers",438396,386531,51865,41991,43848,31023
2017,"Construction managers",709029,652746,56283,72289,73848,65032
2017,"Education administrators",781769,281444,500325,71773,83383,64989
2017,"Architectural and engineering managers",159701,143563,16138,131528,132281,119843
2017,"Food service managers",817831,447481,370350,40011,44606,33735
2017,"Funeral service managers",6330,4348,1982,80057,90264,51232
2017,"Gaming managers",15840,8730,7110,55152,62224,44774
2017,"Lodging managers",112715,53267,59448,47400,52925,42318
2017,"Medical and health services managers",637605,180621,456984,72145,87451,67129
2017,"Natural sciences managers",20107,9524,10583,90355,112309,77050
2017,"Postmasters and mail superintendents",22837,11818,11019,73610,77371,70105
2017,"Property, real estate, and community association managers",480187,242923,237264,52378,61245,47528
2017,"Social and community service managers",328654,103827,224827,59847,66518,56340
2017,"Emergency management directors",8612,5493,3119,67010,77320,64941
2017,"Managers, all other",3899979,2536832,1363147,80402,86960,68744
2017,"Business and Financial Operations Occupations",6327592,2884605,3442987,65590,75902,59584
2017,"Agents and business managers of artists, performers, and athletes",33035,18092,14943,57131,60714,55287
2017,"Buyers and purchasing agents, farm products",6638,4605,2033,61246,74484,56978
2017,"Wholesale and retail buyers, except farm products",134634,69239,65395,43707,41903,45496
2017,"Purchasing agents, except wholesale, retail, and farm products",237095,113159,123936,55491,60735,51439
2017,"Claims adjusters, appraisers, examiners, and investigators",296535,121095,175440,55152,61964,50664
2017,"Compliance officers",248780,117695,131085,68152,72212,63579
2017,"Cost estimators",119438,103589,15849,64155,66596,50499
2017,"Human resources workers",711018,199412,511606,60169,65175,57103
2017,"Compensation, benefits, and job analysis specialists",51568,13370,38198,52936,57162,52201
2017,"Training and development specialists",103451,44813,58638,61259,65750,57341
2017,"Logisticians",127430,82301,45129,52446,56865,49521
2017,"Management analysts",665500,384117,281383,86167,95449,79410
2017,"Meeting, convention, and event planners",91655,17142,74513,51753,53186,51533
2017,"Fundraisers",80259,23676,56583,63831,72390,61197
2017,"Market research analysts and marketing specialists",255502,112345,143157,71157,81222,63932
2017,"Business operations specialists, all other",264025,123232,140793,62141,73016,55038
2017,"Accountants and auditors",1692991,678164,1014827,65597,77320,60280
2017,"Appraisers and assessors of real estate",72566,48063,24503,61310,69684,48855
2017,"Budget analysts",41211,15651,25560,76805,82763,74498
2017,"Credit analysts",25288,12300,12988,61645,71132,51763
2017,"Financial analysts",202163,123379,78784,85696,95022,74888
2017,"Personal financial advisors",338453,229348,109105,93899,108199,71154
2017,"Insurance underwriters",95107,33301,61806,63407,78850,58607
2017,"Financial examiners",12334,6326,6008,86618,100808,81765
2017,"Credit counselors and loan officers",284846,134005,150841,62063,77214,52257
2017,"Tax examiners and collectors, and revenue agents",44684,16612,28072,52704,63310,50638
2017,"Tax preparers",51718,21021,30697,56143,71730,47886
2017,"Financial specialists, all other",39668,18553,21115,66322,100619,49486
2017,"Computer, Engineering, and Science Occupations",7632074,5800427,1831647,81256,84802,71502
2017,"Computer and Mathematical Occupations",4091529,3091982,999547,83469,87012,75555
2017,"Computer and information research scientists",22129,16418,5711,105949,111254,96090
2017,"Computer systems analysts",478879,297409,181470,80145,84033,73321
2017,"Information security analysts",87834,73109,14725,95740,97235,87850
2017,"Computer programmers",371952,294706,77246,86989,88977,82140
2017,"Software developers, applications and systems software",1211419,984505,226914,102204,105996,92304
2017,"Web developers",143349,95527,47822,62890,66667,56439
2017,"Computer support specialists",562145,427841,134304,58930,60702,52069
2017,"Database administrators",100437,65509,34928,86218,92173,72351
2017,"Network and computer systems administrators",195283,159778,35505,73111,75180,66661
2017,"Computer network architects",92409,85518,6891,100214,100205,100349
2017,"Computer occupations, all other",613463,476122,137341,72088,73301,68923
2017,"Actuaries",26642,18601,8041,106764,111182,101188
2017,"Mathematicians",3065,2812,253,76302,75435,158449
2017,"Operations research analysts",131050,67041,64009,80440,85137,75580
2017,"Statisticians",47971,24946,23025,81556,90165,75180
2017,"Miscellaneous mathematical science occupations",3502,2140,1362,94408,101061,57067
2017,"Architecture and Engineering Occupations",2493504,2130607,362897,81751,83593,72047
2017,"Architects, except naval",169366,128183,41183,81205,85783,69280
2017,"Surveyors, cartographers, and photogrammetrists",27850,22654,5196,60771,63671,50554
2017,"Aerospace engineers",123484,108681,14803,103583,106140,92065
2017,"Biomedical engineers",12898,10461,2437,82047,82157,81797
2017,"Chemical engineers",53133,43850,9283,101081,101592,94071
2017,"Civil engineers",317670,273266,44404,85314,87201,76467
2017,"Computer hardware engineers",44685,39377,5308,99645,99943,96416
2017,"Electrical and electronics engineers",196331,178387,17944,100063,100329,88576
2017,"Environmental engineers",24102,17803,6299,81602,84272,72920
2017,"Industrial engineers, including health and safety",197550,155735,41815,80311,81656,72452
2017,"Marine engineers and naval architects",12874,12109,765,89901,90993,71076
2017,"Materials engineers",40500,35251,5249,84016,84098,83955
2017,"Mechanical engineers",237908,217432,20476,86329,86770,82148
2017,"Mining and geological engineers, including mining safety engineers",7189,6898,291,90749,91942,71866
2017,"Nuclear engineers",5675,5161,514,93617,94828,61175
2017,"Petroleum engineers",20608,17654,2954,122057,122475,116617
2017,"Engineers, all other",483758,421002,62756,93893,95852,84891
2017,"Drafters",136643,110692,25951,55693,56936,50184
2017,"Engineering technicians, except drafters",330076,277195,52881,57068,59927,47138
2017,"Surveying and mapping technicians",48988,46707,2281,50230,50754,41024
2017,"Life, Physical, and Social Science Occupations",1047041,577838,469203,66916,71799,62345
2017,"Agricultural and food scientists",22484,13914,8570,61733,65053,56114
2017,"Biological scientists",73165,40197,32968,63528,64904,62379
2017,"Conservation scientists and foresters",17170,12126,5044,60705,62152,54573
2017,"Medical scientists",117204,56415,60789,77897,88050,70267
2017,"Life scientists, all other",2540,993,1547,57472,80134,57458
2017,"Astronomers and physicists",9844,8360,1484,113074,119795,90602
2017,"Atmospheric and space scientists",11183,8687,2496,80964,87399,57166
2017,"Chemists and materials scientists",76920,46650,30270,75302,81000,66186
2017,"Environmental scientists and geoscientists",60714,41589,19125,75771,77490,71906
2017,"Physical scientists, all other",201464,118841,82623,80636,90611,69257
2017,"Economists",24282,17250,7032,107382,120221,95737
2017,"Survey researchers",1621,798,823,51721,70614,34398
2017,"Psychologists",128867,38639,90228,75052,86041,71133
2017,"Urban and regional planners",19850,11026,8824,70712,72456,66909
2017,"Miscellaneous social scientists and related workers, including sociologists",22975,10327,12648,65221,65204,65243
2017,"Agricultural and food science technicians",32481,21424,11057,50136,50938,44725
2017,"Biological technicians",16847,8050,8797,51166,55977,49732
2017,"Chemical technicians",56912,38289,18623,51189,52157,46670
2017,"Geological and petroleum technicians",10856,8406,2450,70128,75240,60911
2017,"Nuclear technicians",3573,3110,463,71454,71771,67135
2017,"Social science research assistants",3301,1276,2025,47047,53974,40933
2017,"Miscellaneous life, physical, and social science technicians",132788,71471,61317,46218,49834,42462
2017,"Education, Legal, Community Service, Arts, and Media Occupations",10873395,4072646,6800749,51525,60609,48245
2017,"Community and Social Service Occupations",2029745,718847,1310898,45541,47178,44800
2017,"Counselors",572271,155941,416330,46346,47207,46104
2017,"Social workers",722010,135139,586871,45835,46906,45644
2017,"Probation officers and correctional treatment specialists",80114,36232,43882,50704,49560,51631
2017,"Social and human service assistants",153684,35178,118506,37021,38499,36747
2017,"Miscellaneous community and social service specialists, including health educators and community health workers",64940,23262,41678,45341,47024,43284
2017,"Clergy",345976,289289,56687,47409,48758,42856
2017,"Directors, religious activities and education",49074,23286,25788,45381,50971,41540
2017,"Religious workers, all other",41676,20520,21156,37730,40918,36413
2017,"Legal Occupations",1403898,688587,715311,90413,122231,67050
2017,"Lawyers",888694,568535,320159,125125,140270,106837
2017,"Judicial law clerks",11427,4596,6831,60939,65928,57421
2017,"Judges, magistrates, and other judicial workers",60833,31989,28844,100815,124620,80238
2017,"Paralegals and legal assistants",317045,48354,268691,50286,51765,50045
2017,"Miscellaneous legal support workers",125899,35113,90786,51081,60513,47505
2017,"Education, Training, and Library Occupations",5528587,1585239,3943348,50307,57802,47033
2017,"Postsecondary teachers",909260,479360,429900,68023,74976,62308
2017,"Preschool and kindergarten teachers",356867,9873,346994,25552,25566,25551
2017,"Elementary and middle school teachers",2480384,547310,1933074,51409,55197,50766
2017,"Secondary school teachers",511675,219493,292182,53741,56547,51925
2017,"Special education teachers",178048,25624,152424,50344,49841,50443
2017,"Other teachers and instructors",387246,178787,208459,46975,53657,41481
2017,"Archivists, curators, and museum technicians",35788,16185,19603,52593,53618,52297
2017,"Librarians",110001,22528,87473,51733,53883,51355
2017,"Library technicians",16144,3925,12219,31088,40570,27869
2017,"Teacher assistants",460672,59475,401197,22919,30970,22140
2017,"Other education, training, and library workers",82502,22679,59823,55423,60119,54346
2017,"Arts, Design, Entertainment, Sports, and Media Occupations",1911165,1079973,831192,52499,57128,50300
2017,"Artists and related workers",125078,78367,46711,46592,51297,38374
2017,"Designers",653906,336687,317219,53050,60718,47783
2017,"Actors",13619,7592,6027,42278,50762,32242
2017,"Producers and directors",131754,82584,49170,63545,66519,60454
2017,"Athletes, coaches, umpires, and related workers",121696,88277,33419,47189,49929,40954
2017,"Dancers and choreographers",7258,1164,6094,36295,31306,36727
2017,"Musicians, singers, and related workers",64811,50687,14124,45254,45108,45502
2017,"Entertainers and performers, sports and related workers, all other",17086,10236,6850,46514,52306,32278
2017,"Announcers",24022,18455,5567,51456,51143,55273
2017,"News analysts, reporters and correspondents",54388,30330,24058,52335,54309,51603
2017,"Public relations specialists",107893,39861,68032,70196,75652,66488
2017,"Editors",121098,60224,60874,57893,60778,55917
2017,"Technical writers",45442,20945,24497,66680,69351,65587
2017,"Writers and authors",143705,65137,78568,55438,56059,55092
2017,"Miscellaneous media and communication workers",68461,25492,42969,47193,50621,46145
2017,"Miscellaneous media and communications equipment workers, including broadcast and sound engineering technicians and radio operators",79113,72407,6706,56772,58619,45693
2017,"Photographers",87173,53785,33388,39540,44639,32872
2017,"Television, video, and motion picture camera operators and editors",44662,37743,6919,55746,56210,50849
2017,"Healthcare Practitioners and Technical Occupations",6787795,1846250,4941545,62232,80092,60334
2017,"Chiropractors",39928,29103,10825,62074,67013,50016
2017,"Dentists",94693,66304,28389,151733,161773,126690
2017,"Dietitians and nutritionists",71289,8548,62741,52016,57317,51834
2017,"Optometrists",26632,15769,10863,110397,120059,102375
2017,"Pharmacists",210886,99370,111516,121345,122441,120173
2017,"Physicians and surgeons",762927,488416,274511,202908,243072,171880
2017,"Physician assistants",80941,27754,53187,101041,115309,97549
2017,"Podiatrists",6762,4880,1882,132242,142230,125138
2017,"Audiologists",13420,2779,10641,76855,84371,75258
2017,"Occupational therapists",68794,8263,60531,70792,76378,70316
2017,"Physical therapists",169495,69499,99996,77510,82804,73717
2017,"Radiation therapists",16601,5558,11043,81413,88099,80676
2017,"Recreational therapists",9248,2080,7168,42293,38491,42474
2017,"Respiratory therapists",88350,34327,54023,58571,62298,55357
2017,"Speech-language pathologists",99885,5703,94182,65364,70329,65183
2017,"Miscellaneous therapists, including exercise physiologists",123114,28257,94857,50625,53196,49697
2017,"Veterinarians",62715,25164,37551,92083,101930,86815
2017,"Registered nurses",2396467,303978,2092489,66243,71590,65612
2017,"Nurse anesthetists",24079,9717,14362,165240,171963,160297
2017,"Nurse practitioners",139295,16625,122670,101302,109760,100914
2017,"Health diagnosing and treating practitioners, all other",16505,5181,11324,50652,50512,50737
2017,"Clinical laboratory technologists and technicians",248936,69924,179012,48571,50108,48241
2017,"Dental hygienists",80259,6458,73801,58032,73438,57050
2017,"Diagnostic related technologists and technicians",284210,95371,188839,59623,62287,56632
2017,"Emergency medical technicians and paramedics",159387,110048,49339,43199,46045,40095
2017,"Health practitioner support technologists and technicians",455672,105447,350225,33232,35538,32486
2017,"Licensed practical and licensed vocational nurses",610860,81120,529740,40774,45518,40393
2017,"Medical records and health information technicians",153611,13685,139926,40152,40793,40107
2017,"Opticians, dispensing",44245,11976,32269,40189,45461,36598
2017,"Miscellaneous health technologists and technicians",114823,42062,72761,42324,50316,40770
2017,"Other healthcare practitioners and technical occupations",110487,52884,57603,55973,60340,51263
2017,"Healthcare Support Occupations",2216406,318796,1897610,29848,32119,29262
2017,"Nursing, psychiatric, and home health aides",1244681,172892,1071789,27078,30125,26816
2017,"Occupational therapy assistants and aides",16092,2526,13566,45100,51335,43869
2017,"Physical therapist assistants and aides",56275,18124,38151,46814,50588,45030
2017,"Massage therapists",65506,14724,50782,31232,34326,30732
2017,"Dental assistants",176166,13392,162774,32250,35599,32194
2017,"Medical assistants",393011,34038,358973,31268,35618,31050
2017,"Medical transcriptionists",23318,3354,19964,32415,26571,33244
2017,"Pharmacy aides",25924,6234,19690,32226,37234,31813
2017,"Veterinary assistants and laboratory animal caretakers",33490,6691,26799,26390,32103,25383
2017,"Phlebotomists",82191,12443,69748,31978,34999,31591
2017,"Healthcare support workers, all other, including medical equipment preparers",99752,34378,65374,31162,36190,29474
2017,"Protective Service Occupations",2581123,2068722,512401,51703,55080,41728
2017,"First-line supervisors of correctional officers",50463,36631,13832,53402,55786,47517
2017,"First-line supervisors of police and detectives",105612,90266,15346,82068,85604,61115
2017,"First-line supervisors of fire fighting and prevention workers",49186,47656,1530,91402,91561,81471
2017,"First-line supervisors of protective service workers, all other",70453,52487,17966,49353,52011,41975
2017,"Firefighters",264896,254482,10414,66199,66243,63098
2017,"Fire inspectors",19480,16205,3275,56925,60981,42419
2017,"Bailiffs, correctional officers, and jailers",358707,259256,99451,46271,49754,40135
2017,"Detectives and criminal investigators",114691,82948,31743,75698,81294,60338
2017,"Fish and game wardens",3957,3692,265,52218,51877,85231
2017,"Parking enforcement workers",6908,3661,3247,39847,41157,37505
2017,"Police and sheriff's patrol officers",707360,611254,96106,64521,65854,57192
2017,"Transit and railroad police",2290,2033,257,54776,52327,54868
2017,"Animal control workers",7761,4210,3551,39148,40500,38670
2017,"Private detectives and investigators",80139,43298,36841,54902,62338,48983
2017,"Security guards and gaming surveillance officers",668744,512464,156280,31516,32003,30072
2017,"Crossing guards",11810,7767,4043,30404,30551,30073
2017,"Transportation security screeners",34738,24827,9911,41184,40959,41918
2017,"Lifeguards and other recreational, and all other protective service workers",23928,15585,8343,31001,33206,26817
2017,"Food Preparation and Serving Related Occupations",3837283,2044072,1793211,23747,26046,21710
2017,"Chefs and head cooks",354511,286759,67752,33028,35198,28971
2017,"First-line supervisors of food preparation and serving workers",428906,197016,231890,27506,32143,24829
2017,"Cooks",1213155,766711,446444,22424,24183,20975
2017,"Food preparation workers",361738,162401,199337,21339,22106,20652
2017,"Bartenders",219856,101394,118462,28524,31863,25822
2017,"Combined food preparation and serving workers, including fast food",142501,54861,87640,20703,20886,20592
2017,"Counter attendants, cafeteria, food concession, and coffee shop",35749,15851,19898,20859,23539,19286
2017,"Waiters and waitresses",752543,273280,479263,22427,26226,21419
2017,"Food servers, nonrestaurant",75048,29547,45501,26125,31117,23698
2017,"Dining room and cafeteria attendants and bartender helpers",86467,52818,33649,21732,23478,20399
2017,"Dishwashers",110647,90347,20300,20628,20674,20381
2017,"Hosts and hostesses, restaurant, lounge, and coffee shop",49771,10322,39449,21198,24377,20763
2017,"Food preparation and serving related workers, all other",6391,2765,3626,24302,26487,23053
2017,"Building and Grounds Cleaning and Maintenance Occupations",3585052,2393665,1191387,27562,31124,22449
2017,"First-line supervisors of housekeeping and janitorial workers",197925,126189,71736,37977,43968,30461
2017,"First-line supervisors of landscaping, lawn service, and groundskeeping workers",127276,119905,7371,41918,42264,32366
2017,"Janitors and building cleaners",1602334,1188748,413586,29971,31782,23143
2017,"Maids and housekeeping cleaners",786916,127984,658932,22049,25297,21634
2017,"Pest control workers",71321,68736,2585,38505,38691,30864
2017,"Grounds maintenance workers",799280,762103,37177,27027,27014,27358
2017,"Personal Care and Service Occupations",2755337,701545,2053792,26054,31141,24682
2017,"First-line supervisors of gaming workers",20535,11089,9446,45192,46776,40393
2017,"First-line supervisors of personal service workers",71661,28432,43229,36108,39486,33819
2017,"Animal trainers",31498,15169,16329,28792,35044,25818
2017,"Nonfarm animal caretakers",124837,34640,90197,26243,31180,24522
2017,"Gaming services workers",66544,34568,31976,40835,41996,38645
2017,"Motion picture projectionists",1927,1606,321,40083,39792,52607
2017,"Ushers, lobby attendants, and ticket takers",6506,3013,3493,20346,17730,21761
2017,"Miscellaneous entertainment attendants and related workers",53918,29319,24599,25458,25908,24777
2017,"Embalmers and funeral attendants",5593,3885,1708,29472,30992,25846
2017,"Morticians, undertakers, and funeral directors",31465,23634,7831,51453,56206,41824
2017,"Barbers",74451,63708,10743,27087,27440,25644
2017,"Hairdressers, hairstylists, and cosmetologists",437356,45081,392275,27132,32294,26698
2017,"Miscellaneous personal appearance workers",191738,32838,158900,24580,25796,24266
2017,"Baggage porters, bellhops, and concierges",69575,54415,15160,32343,33795,30845
2017,"Tour and travel guides",19036,13519,5517,32011,35535,30249
2017,"Childcare workers",537110,32541,504569,21640,24812,21465
2017,"Personal care aides",716208,140442,575766,24061,26882,23357
2017,"Recreation and fitness workers",186243,83528,102715,32407,36949,30940
2017,"Residential advisors",26883,10999,15884,28880,27739,29288
2017,"Personal care and service workers, all other",82253,39119,43134,27529,30129,26376
2017,"Sales and Related Occupations",10133059,5927866,4205193,45567,52335,35512
2017,"First-line supervisors of retail sales workers",2693008,1515173,1177835,41186,47774,35217
2017,"First-line supervisors of non-retail sales workers",1119323,775982,343341,65884,69541,60255
2017,"Cashiers",1017176,294567,722609,21822,23008,21471
2017,"Counter and rental clerks",44808,25846,18962,32555,38245,27165
2017,"Parts salespersons",87054,76519,10535,39061,40628,27363
2017,"Retail salespersons",1684365,1039912,644453,34075,40182,27800
2017,"Advertising sales agents",131371,67443,63928,60821,64331,55584
2017,"Insurance sales agents",453892,241796,212096,51406,61768,42951
2017,"Securities, commodities, and financial services sales agents",204326,143754,60572,83883,101423,61936
2017,"Travel agents",47354,9755,37599,41549,44333,41229
2017,"Sales representatives, services, all other",552560,387383,165177,68202,72423,57708
2017,"Sales representatives, wholesale and manufacturing",1183813,872177,311636,67473,71461,58261
2017,"Models, demonstrators, and product promoters",14331,7072,7259,36776,37638,34809
2017,"Real estate brokers and sales agents",593173,289734,303439,60583,70504,51554
2017,"Sales engineers",34785,32068,2717,102214,103673,85015
2017,"Telemarketers",30173,12789,17384,27551,32194,25227
2017,"Door-to-door sales workers, news and street vendors, and related workers",46425,23880,22545,30808,35569,27070
2017,"Sales and related workers, all other",195122,112016,83106,57842,67634,47543
2017,"Office and Administrative Support Occupations",13620469,4034756,9585713,37050,40709,36261
2017,"First-line supervisors of office and administrative support workers",1203016,473031,729985,50699,57466,46555
2017,"Switchboard operators, including answering service",16429,3478,12951,31878,40768,30888
2017,"Telephone operators",31805,10549,21256,31268,35751,30394
2017,"Communications equipment operators, all other",7609,3491,4118,46797,48555,45638
2017,"Bill and account collectors",122378,36978,85400,36186,36862,35861
2017,"Billing and posting clerks",407686,47376,360310,35796,41864,35393
2017,"Bookkeeping, accounting, and auditing clerks",842584,119242,723342,40380,45254,39939
2017,"Gaming cage workers",4972,2132,2840,35238,35708,30508
2017,"Payroll and timekeeping clerks",132538,15765,116773,43387,45844,43149
2017,"Procurement clerks",33963,16039,17924,56124,67528,50338
2017,"Tellers",203015,28741,174274,27000,27347,26947
2017,"Financial clerks, all other",115603,49999,65604,60604,80985,49816
2017,"Brokerage clerks",6605,1752,4853,51398,61494,47062
2017,"Correspondence clerks",2471,1001,1470,47691,63705,44929
2017,"Court, municipal, and license clerks",61922,14945,46977,40304,40512,40222
2017,"Credit authorizers, checkers, and clerks",38525,9286,29239,38691,57500,36756
2017,"Customer service representatives",1836583,640070,1196513,34961,37623,32893
2017,"Eligibility interviewers, government programs",64653,14401,50252,44485,47828,42439
2017,"File clerks",124102,29885,94217,35821,39254,35261
2017,"Hotel, motel, and resort desk clerks",86663,32760,53903,24501,25596,23610
2017,"Interviewers, except eligibility and loan",85368,15814,69554,34055,37190,32917
2017,"Library assistants, clerical",36328,6671,29657,29799,33696,28868
2017,"Loan interviewers and clerks",111534,26458,85076,43159,46688,42255
2017,"New accounts clerks",14112,4045,10067,39107,51051,36981
2017,"Order clerks",91990,44011,47979,32375,33006,32069
2017,"Human resources assistants, except payroll and timekeeping",41006,7217,33789,41261,51964,40414
2017,"Receptionists and information clerks",691046,73841,617205,29059,30319,28919
2017,"Reservation and transportation ticket agents and travel clerks",97194,45511,51683,40338,44941,36716
2017,"Information and record clerks, all other",78742,19741,59001,39865,46415,37413
2017,"Cargo and freight agents",22352,15124,7228,40887,41089,40376
2017,"Couriers and messengers",153472,131027,22445,37879,40019,31857
2017,"Dispatchers",249122,111248,137874,39858,42333,37240
2017,"Meter readers, utilities",20732,17408,3324,40671,40385,42573
2017,"Postal service clerks",92916,44245,48671,55826,57296,52743
2017,"Postal service mail carriers",276073,173792,102281,56413,59014,51745
2017,"Postal service mail sorters, processors, and processing machine operators",58192,29659,28533,55151,56403,51737
2017,"Production, planning, and expediting clerks",282146,119402,162744,47966,60836,41040
2017,"Shipping, receiving, and traffic clerks",458469,324665,133804,31942,32986,30251
2017,"Stock clerks and order fillers",913043,595016,318027,28302,29315,27125
2017,"Weighers, measurers, checkers, and samplers, recordkeeping",66649,35112,31537,36968,41199,33182
2017,"Secretaries and administrative assistants",2189662,129373,2060289,38820,42566,38470
2017,"Computer operators",69888,40056,29832,43029,46855,39740
2017,"Data entry keyers",223130,51605,171525,32915,36384,32202
2017,"Word processors and typists",186327,28511,157816,36004,37699,35736
2017,"Desktop publishers",1475,761,714,42550,45125,41761
2017,"Insurance claims and policy processing clerks",321692,65610,256082,38877,43064,37365
2017,"Mail clerks and mail machine operators, except postal service",49359,27621,21738,31674,32225,31195
2017,"Office clerks, general",901683,167061,734622,35738,39160,35226
2017,"Office machine operators, except computer",24718,9732,14986,31350,34228,28760
2017,"Proofreaders and copy markers",6550,2307,4243,42082,46324,40192
2017,"Statistical assistants",22427,10721,11706,51388,55572,46920
2017,"Office and administrative support workers, all other",439950,110470,329480,41697,49019,40437
2017,"Natural Resources, Construction, and Maintenance Occupations",10665395,10227297,438098,41963,42203,31725
2017,"Farming, Fishing, and Forestry Occupations",654874,529575,125299,27462,30115,21200
2017,"First-line supervisors of farming, fishing, and forestry workers",47294,42194,5100,44527,45186,40951
2017,"Agricultural inspectors",9462,5085,4377,50684,52859,50264
2017,"Animal breeders",2563,1790,773,38413,38905,36341
2017,"Graders and sorters, agricultural products",37019,15649,21370,21959,27475,20630
2017,"Miscellaneous agricultural workers",493053,403204,89849,26167,27338,20397
2017,"Fishing and hunting workers",18604,17578,1026,40241,40468,31085
2017,"Forest and conservation workers",10346,8638,1708,35955,35452,41667
2017,"Logging workers",36533,35437,1096,36091,36377,32612
2017,"Construction and Extraction Occupations",6025290,5857738,167552,41334,41422,35760
2017,"First-line supervisors of construction trades and extraction workers",730631,709246,21385,60347,60404,54379
2017,"Boilermakers",12237,11759,478,51254,51281,49827
2017,"Brickmasons, blockmasons, and stonemasons",92826,92171,655,38641,38506,51062
2017,"Carpenters",915998,898938,17060,37471,37689,31022
2017,"Carpet, floor, and tile installers and finishers",110577,108069,2508,34959,35113,30833
2017,"Cement masons, concrete finishers, and terrazzo workers",46830,46001,829,40015,39611,53025
2017,"Construction laborers",1279421,1242848,36573,33685,33902,30927
2017,"Paving, surfacing, and tamping equipment operators",9391,8829,562,37174,37960,33424
2017,"Operating engineers and other construction equipment operators, including pile-driver operators",270110,264567,5543,48740,49020,35091
2017,"Drywall installers, ceiling tile installers, and tapers",109053,106543,2510,31549,31584,25583
2017,"Electricians",708412,694430,13982,50720,50785,43452
2017,"Glaziers",39119,38100,1019,41779,42033,33178
2017,"Insulation workers",36047,33856,2191,40745,41031,37707
2017,"Painters, construction and maintenance",399807,379105,20702,31879,31983,30543
2017,"Paperhangers",3501,2917,584,40642,41489,30565
2017,"Pipelayers, plumbers, pipefitters, and steamfitters",479928,473439,6489,46684,46801,41142
2017,"Roofers",150660,149546,1114,33744,33713,36389
2017,"Sheet metal workers",98878,94722,4156,43890,44371,31976
2017,"Structural iron and steel workers",49348,47306,2042,50820,51104,29063
2017,"Helpers, construction trades",26537,25117,1420,27467,28043,22126
2017,"Construction and building inspectors",78867,67676,11191,57347,60469,42476
2017,"Elevator installers and repairers",23542,22950,592,80670,81119,57000
2017,"Fence erectors",21700,20775,925,31219,30864,43828
2017,"Hazardous materials removal workers",27627,22970,4657,44341,46269,26809
2017,"Highway maintenance workers",83209,80964,2245,40115,40136,37034
2017,"Septic tank servicers and sewer pipe cleaners",7458,7096,362,42483,42980,38580
2017,"Miscellaneous construction and related workers, including solar photovoltaic installers",41911,41062,849,39697,40006,35719
2017,"Derrick, rotary drill, and service unit operators, oil, gas, and mining",18577,18187,390,52365,52487,29429
2017,"Earth drillers, except oil and gas",19699,19363,336,50056,49230,61808
2017,"Explosives workers, ordnance handling experts, and blasters",6931,6819,112,52198,52230,43684
2017,"Mining machine operators",47419,46163,1256,62416,62746,57689
2017,"Other extraction workers",40529,38418,2111,50754,51058,42033
2017,"Installation, Maintenance, and Repair Occupations",3985231,3839984,145247,46973,47168,41113
2017,"First-line supervisors of mechanics, installers, and repairers",239714,222381,17333,61038,61390,51075
2017,"Computer, automated teller, and office machine repairers",134991,120161,14830,45104,45506,40421
2017,"Radio and telecommunications equipment installers and repairers",120104,107256,12848,55319,56209,46702
2017,"Avionics technicians",12304,10665,1639,59432,59484,52154
2017,"Electric motor, power tool, and related repairers",20180,19352,828,50894,51272,29605
2017,"Electrical and electronics repairers, industrial and utility",10025,9650,375,71581,72686,50648
2017,"Electronic equipment installers and repairers, motor vehicles",6671,6287,384,40379,40298,40491
2017,"Electronic home entertainment equipment installers and repairers",30089,28423,1666,43847,44883,39352
2017,"Security and fire alarm systems installers",49457,48296,1161,49609,50005,32367
2017,"Aircraft mechanics and service technicians",153320,145032,8288,60938,61171,51795
2017,"Automotive body and related repairers",118567,115831,2736,41442,41426,46057
2017,"Automotive glass installers and repairers",16307,15588,719,38948,39684,26437
2017,"Automotive service technicians and mechanics",729510,715176,14334,37727,38015,30378
2017,"Bus and truck mechanics and diesel engine specialists",257847,253739,4108,46652,46620,47752
2017,"Heavy vehicle and mobile equipment service technicians and mechanics",185480,183456,2024,51849,51862,50813
2017,"Small engine mechanics",31400,30594,806,32358,32291,35540
2017,"Miscellaneous vehicle and mobile equipment mechanics, installers, and repairers",58823,57778,1045,31542,31613,30147
2017,"Control and valve installers and repairers",19283,17877,1406,55603,55722,54306
2017,"Heating, air conditioning, and refrigeration mechanics and installers",348477,342338,6139,46764,46818,42223
2017,"Home appliance repairers",36832,35921,911,39211,40232,26363
2017,"Industrial and refractory machinery mechanics",337283,327038,10245,51746,51941,42105
2017,"Maintenance and repair workers, general",449315,434104,15211,46094,46257,40810
2017,"Maintenance workers, machinery",23942,22837,1105,51004,50789,63593
2017,"Millwrights",34547,33445,1102,61775,61889,44623
2017,"Electrical power-line installers and repairers",100961,99798,1163,75631,75822,50090
2017,"Telecommunications line installers and repairers",131557,127063,4494,50219,50264,46686
2017,"Precision instrument and equipment repairers",49377,44172,5205,51059,52335,32876
2017,"Coin, vending, and amusement machine servicers and repairers",26670,24552,2118,35424,35921,33239
2017,"Locksmiths and safe repairers",18561,17814,747,40887,40847,41813
2017,"Riggers",12369,12039,330,45997,46146,41994
2017,"Helpers--installation, maintenance, and repair workers",11404,10959,445,26323,26018,57999
2017,"Other installation, maintenance, and repair workers, including wind turbine service technicians",199121,189946,9175,41498,41843,32133
2017,"Production Occupations",7197169,5306230,1890939,37542,41565,29317
2017,"First-line supervisors of production and operating workers",852644,688229,164415,54522,57369,41044
2017,"Aircraft structure, surfaces, rigging, and systems assemblers",5094,3710,1384,48807,55596,36856
2017,"Electrical, electronics, and electromechanical assemblers",99081,51135,47946,32322,36447,29528
2017,"Engine and other machine assemblers",8428,7460,968,43402,46721,27594
2017,"Structural metal fabricators and fitters",21214,19667,1547,45773,46996,30441
2017,"Miscellaneous assemblers and fabricators",812138,513667,298471,32335,35572,29805
2017,"Bakers",148290,67152,81138,26803,30228,25379
2017,"Butchers and other meat, poultry, and fish processing workers",208070,161922,46148,30268,31519,24581
2017,"Food and tobacco roasting, baking, and drying machine operators and tenders",6138,4300,1838,31702,31899,24498
2017,"Food batchmakers",54457,22052,32405,30788,37063,26119
2017,"Food cooking machine operators and tenders",6798,4155,2643,30302,30542,29335
2017,"Food processing workers, all other",112774,75374,37400,32934,36312,28755
2017,"Computer control programmers and operators",82878,76011,6867,45465,46594,33164
2017,"Extruding and drawing machine setters, operators, and tenders, metal and plastic",8546,7516,1030,45528,48861,29076
2017,"Forging machine setters, operators, and tenders, metal and plastic",6772,6457,315,45213,45088,52215
2017,"Rolling machine setters, operators, and tenders, metal and plastic",10246,7926,2320,34773,38571,27269
2017,"Cutting, punching, and press machine setters, operators, and tenders, metal and plastic",68488,56773,11715,35283,36160,31284
2017,"Drilling and boring machine tool setters, operators, and tenders, metal and plastic",3619,2860,759,37188,45000,22207
2017,"Grinding, lapping, polishing, and buffing machine tool setters, operators, and tenders, metal and plastic",37882,33057,4825,35700,36596,28961
2017,"Lathe and turning machine tool setters, operators, and tenders, metal and plastic",6547,6076,471,41946,45551,29501
2017,"Machinists",309105,297587,11518,47462,48218,33649
2017,"Metal furnace operators, tenders, pourers, and casters",20729,18603,2126,41887,41845,42247
2017,"Model makers and patternmakers, metal and plastic",4719,4230,489,56525,60121,27393
2017,"Molders and molding machine setters, operators, and tenders, metal and plastic",34703,29246,5457,37192,39973,30580
2017,"Multiple machine tool setters, operators, and tenders, metal and plastic",3357,3040,317,47236,50027,31754
2017,"Tool and die makers",50913,50010,903,57247,57493,35400
2017,"Welding, soldering, and brazing workers",505665,479158,26507,41309,41713,31302
2017,"Heat treating equipment setters, operators, and tenders, metal and plastic",5189,4682,507,44268,50295,14439
2017,"Layout workers, metal and plastic",4771,3691,1080,45555,44185,56660
2017,"Plating and coating machine setters, operators, and tenders, metal and plastic",13750,12457,1293,37679,37698,37284
2017,"Tool grinders, filers, and sharpeners",5032,4740,292,42343,45449,24886
2017,"Metal workers and plastic workers, all other",333686,260574,73112,35911,37746,30130
2017,"Prepress technicians and workers",19996,12964,7032,40945,45622,30148
2017,"Printing workers, except prepress technicians and workers",157101,123439,33662,36625,39540,28060
2017,"Laundry and dry-cleaning workers",107437,38432,69005,22061,26615,20764
2017,"Pressers, textile, garment, and related materials",23521,9797,13724,23038,30591,21459
2017,"Sewing machine operators",127056,36567,90489,23845,27336,22522
2017,"Shoe and leather workers and repairers",8063,6424,1639,31217,32687,24462
2017,"Shoe machine operators and tenders",2534,1099,1435,35938,44081,31313
2017,"Tailors, dressmakers, and sewers",44236,12873,31363,27341,30237,26680
2017,"Textile bleaching and dyeing machine operators and tenders",1574,1107,467,26030,27068,19161
2017,"Textile cutting machine setters, operators, and tenders",4040,2482,1558,27082,27311,24700
2017,"Textile knitting and weaving machine setters, operators, and tenders",6080,2083,3997,28696,29726,28114
2017,"Textile winding, twisting, and drawing out machine setters, operators, and tenders",8799,2589,6210,28324,31271,27191
2017,"Fabric and apparel patternmakers",2774,533,2241,65821,51720,72163
2017,"Upholsterers",24402,21629,2773,33203,33110,34258
2017,"Miscellaneous textile, apparel, and furnishings workers, including extruding and forming machine setters, operators, and tenders, synthetic and glass fibers",12368,7336,5032,26329,30482,23067
2017,"Cabinetmakers and bench carpenters",45404,42815,2589,32598,33368,25284
2017,"Furniture finishers",8688,6975,1713,34683,36105,24972
2017,"Sawing machine setters, operators, and tenders, wood",24130,21653,2477,31931,31814,34750
2017,"Woodworking machine setters, operators, and tenders, except sawing",16253,12923,3330,30516,31854,25166
2017,"Miscellaneous woodworkers, including model makers and patternmakers",20478,19453,1025,34241,34833,24955
2017,"Power plant operators, distributors, and dispatchers",44532,41206,3326,88804,90074,81636
2017,"Stationary engineers and boiler operators",71365,69029,2336,61000,61041,56568
2017,"Water and wastewater treatment plant and system operators",82212,78713,3499,49980,50315,37750
2017,"Miscellaneous plant and system operators",45578,41908,3670,73230,72459,87726
2017,"Chemical processing machine setters, operators, and tenders",56539,50552,5987,50035,50855,37374
2017,"Crushing, grinding, polishing, mixing, and blending workers",72186,63196,8990,38457,39724,33875
2017,"Cutting workers",48139,37439,10700,31437,32425,26051
2017,"Extruding, forming, pressing, and compacting machine setters, operators, and tenders",25714,21566,4148,37038,37224,33072
2017,"Furnace, kiln, oven, drier, and kettle operators and tenders",9506,7648,1858,41198,41884,32408
2017,"Inspectors, testers, sorters, samplers, and weighers",668310,425400,242910,41157,46955,32280
2017,"Jewelers and precious stone and metal workers",20395,13912,6483,35856,37862,32387
2017,"Medical, dental, and ophthalmic laboratory technicians",60812,31313,29499,38010,41432,35271
2017,"Packaging and filling machine operators and tenders",213335,103479,109856,27308,31185,25435
2017,"Painting workers",126613,114241,12372,37028,37837,31785
2017,"Photographic process workers and processing machine operators",18756,11947,6809,50076,60944,32498
2017,"Semiconductor processors",1176,720,456,50717,57237,32143
2017,"Adhesive bonding machine operators and tenders",7962,5120,2842,28121,32471,23386
2017,"Cleaning, washing, and metal pickling equipment operators and tenders",3873,2675,1198,28140,29604,25000
2017,"Cooling and freezing equipment operators and tenders",2645,2528,117,40626,40692,31691
2017,"Etchers and engravers",8062,5919,2143,32241,32802,29444
2017,"Molders, shapers, and casters, except metal and plastic",22345,20292,2053,36210,36630,30483
2017,"Paper goods machine setters, operators, and tenders",15556,11646,3910,46013,51604,24303
2017,"Tire builders",11883,10207,1676,45809,45035,50549
2017,"Helpers--production workers",28502,21325,7177,27776,28127,26907
2017,"Production workers, all other",1012889,745978,266911,35511,38037,28956
2017,"Transportation and Material Moving Occupations",6852836,5871227,981609,37079,39715,28344
2017,"Transportation Occupations",4118728,3667169,451559,42227,44173,31941
2017,"Supervisors of transportation and material moving workers",200528,153843,46685,51106,53250,41077
2017,"Aircraft pilots and flight engineers",102013,96577,5436,110765,111715,100611
2017,"Air traffic controllers and airfield operations specialists",31509,26231,5278,91982,91716,93118
2017,"Flight attendants",57865,16901,40964,46757,51911,45403
2017,"Ambulance drivers and attendants, except emergency medical technicians",9195,5954,3241,30563,30942,30161
2017,"Bus drivers",279333,162288,117045,34829,40195,30126
2017,"Driver/sales workers and truck drivers",2728976,2585286,143690,43252,44476,31491
2017,"Taxi drivers and chauffeurs",348385,303426,44959,29942,30390,26286
2017,"Motor vehicle operators, all other",20604,17227,3377,30245,32049,18250
2017,"Locomotive engineers and operators",45734,43633,2101,80589,80918,71829
2017,"Railroad brake, signal, and switch operators",3289,2963,326,51374,51594,31529
2017,"Railroad conductors and yardmasters",45078,41327,3751,70624,71537,59065
2017,"Subway, streetcar, and other rail transportation workers",16319,14029,2290,62201,63626,53560
2017,"Sailors and marine oilers",15897,14669,1228,45046,48060,26484
2017,"Ship and boat captains and operators",24614,22972,1642,77335,77409,71289
2017,"Ship engineers",4011,3711,300,79275,78407,79572
2017,"Bridge and lock tenders",2822,2601,221,56836,57152,31864
2017,"Parking lot attendants",50607,44340,6267,25133,25640,21573
2017,"Automotive and watercraft service attendants",54715,48711,6004,24156,24644,20697
2017,"Transportation inspectors",39167,32930,6237,61909,66767,37157
2017,"Transportation attendants, except flight attendants",16231,7588,8643,27324,30883,24992
2017,"Other transportation workers",21836,19962,1874,41018,40568,48071
2017,"Material Moving Occupations",2734108,2204058,530050,30841,31790,25935
2017,"Conveyor operators and tenders",4446,3363,1083,33777,36328,19295
2017,"Crane and tower operators",50453,49345,1108,53853,54405,41042
2017,"Dredge, excavating, and loading machine operators",27720,27354,366,45094,45542,30667
2017,"Hoist and winch operators",6051,5411,640,36941,37135,35698
2017,"Industrial truck and tractor operators",516774,478039,38735,32992,33179,31957
2017,"Cleaners of vehicles and equipment",224432,192341,32091,26138,26279,25239
2017,"Laborers and freight, stock, and material movers, hand",1439725,1182110,257615,31058,31775,26691
2017,"Machine feeders and offbearers",20661,12299,8362,30231,32028,27362
2017,"Packers and packagers, hand",323542,143980,179562,24658,26024,23333
2017,"Pumping station operators",19097,18542,555,60445,60607,53357
2017,"Refuse and recyclable material collectors",62629,57522,5107,34203,35407,25609
2017,"Tank car, truck, and ship loaders",3486,3399,87,46162,46855,26115
2017,"Material moving workers, all other",34943,30204,4739,38823,40183,30579
2018,"Chief executives",1101164,832690,268474,141457,151775,112862
2018,"General and operations managers",904378,621121,283257,72325,79457,60618
2018,"Legislators",11825,6935,4890,60347,67942,51778
2018,"Advertising and promotions managers",46207,21724,24483,68182,86250,57391
2018,"Marketing managers",450049,186650,263399,80913,96454,72604
2018,"Sales managers",417619,285128,132491,96161,102584,71256
2018,"Public relations and fundraising managers",56030,20697,35333,78311,82433,76334
2018,"Administrative services managers",43078,14010,29068,70111,77542,67049
2018,"Facilities managers",95448,76724,18724,70445,72444,57473
2018,"Computer and information systems managers",542094,391795,150299,110478,114722,100131
2018,"Financial managers",1086426,507101,579325,81061,101932,66357
2018,"Compensation and benefits managers",17631,3642,13989,80673,109803,76438
2018,"Human resources managers",369384,151814,217570,75554,81515,71384
2018,"Training and development managers",44218,22557,21661,80696,83616,75977
2018,"Industrial production managers",236747,187198,49549,80221,81552,68280
2018,"Purchasing managers",183758,94755,89003,77892,85405,71060
2018,"Transportation, storage, and distribution managers",227189,187270,39919,55313,55443,54531
2018,"Farmers, ranchers, and other agricultural managers",457998,401682,56316,41277,42213,30457
2018,"Construction managers",629662,581374,48288,76244,76882,65147
2018,"Education and childcare administrators",805328,294708,510620,72336,82848,66300
2018,"Architectural and engineering managers",166218,149509,16709,137212,137480,131819
2018,"Food service managers",808172,429143,379029,40453,46512,35261
2018,"Funeral home managers",6843,4596,2247,62418,68660,46752
2018,"Entertainment and recreation managers",45673,27226,18447,55297,58621,49938
2018,"Lodging managers",111989,55353,56636,48319,53790,44254
2018,"Medical and health services managers",649484,188235,461249,72464,90218,67316
2018,"Natural sciences managers",22035,9678,12357,80115,83988,74241
2018,"Postmasters and mail superintendents",23194,10245,12949,73937,80219,69293
2018,"Property, real estate, and community association managers",496001,250049,245952,55559,65404,50139
2018,"Social and community service managers",330271,103071,227200,58946,67005,55766
2018,"Emergency management directors",7937,5164,2773,73731,76940,71218
2018,"Personal service managers, all other",2172,1069,1103,80240,98855,47113
2018,"Managers, all other",3479567,2312994,1166573,80600,86883,68803
2018,"Business and Financial Operations Occupations:",7088377,3332992,3755385,69520,79998,61601
2018,"Agents and business managers of artists, performers, and athletes",29985,16496,13489,55472,64400,47384
2018,"Buyers and purchasing agents, farm products",7988,5121,2867,52729,56326,45386
2018,"Wholesale and retail buyers, except farm products",135485,64878,70607,44333,42265,45749
2018,"Purchasing agents, except wholesale, retail, and farm products",248155,119378,128777,57075,61580,53479
2018,"Claims adjusters, appraisers, examiners, and investigators",297641,126067,171574,55800,61897,51267
2018,"Compliance officers",253208,116306,136902,70826,75142,68030
2018,"Cost estimators",124514,105306,19208,66223,70359,50404
2018,"Human resources workers",757654,201217,556437,61387,71761,59431
2018,"Compensation, benefits, and job analysis specialists",49208,12364,36844,56436,72347,54121
2018,"Training and development specialists",125939,62807,63132,61969,66798,58609
2018,"Logisticians",122630,81436,41194,52096,56251,49367
2018,"Project management specialists",647053,371049,276004,89772,96120,80990
2018,"Management analysts",676874,402064,274810,87279,94471,80422
2018,"Meeting, convention, and event planners",90502,19582,70920,51160,50196,51389
2018,"Fundraisers",77674,23723,53951,67625,75546,65731
2018,"Market research analysts and marketing specialists",264543,111080,153463,72954,82270,68497
2018,"Business operations specialists, all other",277310,132482,144828,61993,72851,52250
2018,"Accountants and auditors",1687017,692381,994636,67272,78780,61311
2018,"Property appraisers and assessors",73846,48387,25459,61990,66491,52175
2018,"Budget analysts",43187,16609,26578,79237,86628,72318
2018,"Credit analysts",26597,12910,13687,59884,64405,56210
2018,"Financial and investment analysts",194121,118093,76028,84729,91136,78760
2018,"Personal financial advisors",326971,233304,93667,101223,120128,71122
2018,"Insurance underwriters",97430,36329,61101,67410,79979,62092
2018,"Financial examiners",13280,5504,7776,80080,92952,74235
2018,"Credit counselors and loan officers",288995,133547,155448,61595,80299,51718
2018,"Tax examiners and collectors, and revenue agents",45644,16952,28692,54651,61774,50723
2018,"Tax preparers",54035,20663,33372,57151,67983,50105
2018,"Other financial specialists",50891,26957,23934,71526,90593,55664
2018,"Computer, Engineering, and Science Occupations:",8095862,6081337,2014525,81695,85843,72103
2018,"Computer and Mathematical Occupations:",4371077,3255410,1115667,85063,89396,75914
2018,"Computer and information research scientists",26610,19872,6738,109034,117799,91127
2018,"Computer systems analysts",487730,290003,197727,80814,85856,74558
2018,"Information security analysts",99480,81326,18154,100118,101256,87200
2018,"Computer programmers",369439,293596,75843,90457,91319,84680
2018,"Software developers",1201088,995538,205550,107418,110968,98497
2018,"Software quality assurance analysts and testers",59344,34006,25338,78752,78984,78156
2018,"Web developers",89387,60299,29088,67834,72419,61072
2018,"Web and digital interface designers",54733,33520,21213,55765,57232,53144
2018,"Computer support specialists",576376,435420,140956,60167,61340,55416
2018,"Database administrators and architects",107735,71096,36639,88975,95869,72122
2018,"Network and computer systems administrators",192191,157148,35043,74070,75670,66132
2018,"Computer network architects",95954,88204,7750,100048,100636,90270
2018,"Computer occupations, all other",707125,533696,173429,71473,72823,66131
2018,"Actuaries",31925,18980,12945,123604,129235,120703
2018,"Mathematicians",2317,1928,389,120386,120697,101454
2018,"Operations research analysts",137159,67251,69908,80422,85990,75440
2018,"Statisticians",38661,21039,17622,92313,98879,86704
2018,"Other mathematical science occupations",93823,52488,41335,76531,83199,69731
2018,"Architecture and Engineering Occupations:",2569159,2183203,385956,82281,85119,73701
2018,"Architects, except landscape and naval",157873,115088,42785,82471,89070,72849
2018,"Landscape architects",21443,14802,6641,62575,66429,60528
2018,"Surveyors, cartographers, and photogrammetrists",28382,23519,4863,60834,62056,51921
2018,"Aerospace engineers",121570,104411,17159,105992,109161,94871
2018,"Agricultural engineers",2202,2113,89,89085,89990,65905
2018,"Bioengineers and biomedical engineers",10706,8006,2700,86692,89541,69012
2018,"Chemical engineers",60894,50318,10576,101160,102476,91443
2018,"Civil engineers",325223,283630,41593,86768,88641,75597
2018,"Computer hardware engineers",43015,37353,5662,102218,105717,100089
2018,"Electrical and electronics engineers",180373,160266,20107,99690,100641,85051
2018,"Environmental engineers",24782,17621,7161,82066,86053,80155
2018,"Industrial engineers, including health and safety",201660,160453,41207,82235,83678,78733
2018,"Marine engineers and naval architects",13471,11752,1719,82742,83881,69349
2018,"Materials engineers",35025,31376,3649,84735,85498,80486
2018,"Mechanical engineers",247884,228058,19826,86737,87053,82145
2018,"Mining and geological engineers, including mining safety engineers",7961,6653,1308,90091,91096,82059
2018,"Nuclear engineers",5330,4584,746,100645,101673,82423
2018,"Petroleum engineers",21231,18232,2999,125827,128066,91653
2018,"Engineers, all other",491584,426819,64765,98063,100119,90124
2018,"Architectural and civil drafters",44692,36960,7732,55414,56567,50180
2018,"Other drafters",89876,72319,17557,55216,57288,47192
2018,"Electrical and electronic engineering technologists and technicians",77889,70811,7078,63396,65811,51224
2018,"Other engineering technologists and technicians, except drafters",306893,252699,54194,57054,60084,50119
2018,"Surveying and mapping technicians",49200,45360,3840,50066,50523,44034
2018,"Life, Physical, and Social Science Occupations:",1155626,642724,512902,68191,71923,63226
2018,"Agricultural and food scientists",20703,13802,6901,68726,73055,60177
2018,"Biological scientists",72954,36495,36459,64377,66837,62451
2018,"Conservation scientists and foresters",17519,13697,3822,58630,57121,61698
2018,"Medical scientists",122316,54934,67382,78721,92950,72125
2018,"Life scientists, all other",1135,686,449,56885,56714,80702
2018,"Astronomers and physicists",9208,6671,2537,100719,115227,75622
2018,"Atmospheric and space scientists",8117,6365,1752,67715,72228,51614
2018,"Chemists and materials scientists",82241,51631,30610,75771,79068,72156
2018,"Environmental scientists and specialists, including health",25288,14228,11060,65946,69253,62219
2018,"Geoscientists and hydrologists, except geographers",34999,26549,8450,89525,94160,71861
2018,"Physical scientists, all other",230136,135011,95125,80083,87871,70087
2018,"Economists",23387,16862,6525,111788,121974,95445
2018,"Survey researchers",750,270,480,99155,130984,95878
2018,"Clinical and counseling psychologists",15902,5849,10053,78580,101243,73402
2018,"School psychologists",29534,5516,24018,70847,77237,68640
2018,"Other psychologists",86636,27818,58818,80168,91009,75934
2018,"Sociologists",1623,779,844,62066,76304,56280
2018,"Urban and regional planners",17751,9469,8282,75871,77247,72352
2018,"Miscellaneous social scientists and related workers",28576,13794,14782,71145,76488,65450
2018,"Agricultural and food science technicians",38434,24432,14002,46353,50117,40899
2018,"Biological technicians",19534,10446,9088,52206,55302,46429
2018,"Chemical technicians",58960,40359,18601,52619,55441,49178
2018,"Environmental science and geoscience technicians",15719,12054,3665,67342,66820,70698
2018,"Social science research assistants",2902,1617,1285,60525,56435,61097
2018,"Other life, physical, and social science technicians",129366,70932,58434,44695,47010,41405
2018,"Occupational health and safety specialists and technicians",59994,40551,19443,70102,71524,66575
2018,"Education, Legal, Community Service, Arts, and Media Occupations:",11008551,4107006,6901545,52372,61666,49995
2018,"Community and Social Service Occupations:",2016345,712787,1303558,46717,48773,45904
2018,"Substance abuse and behavioral disorder counselors",68090,21225,46865,42090,42305,42012
2018,"Educational, guidance, and career counselors and advisors",243595,57568,186027,51145,50568,51297
2018,"Marriage and family therapists",14142,3216,10926,46584,51807,44493
2018,"Mental health counselors",73877,17163,56714,47874,50632,47002
2018,"Rehabilitation counselors",20658,5295,15363,50897,56412,48679
2018,"Counselors, all other",145858,52494,93364,42263,43680,41908
2018,"Child, family, and school social workers",47516,8988,38528,45462,45181,45527
2018,"Healthcare social workers",83960,21951,62009,45276,43154,45668
2018,"Mental health and substance abuse social workers",9908,1948,7960,57642,60880,55216
2018,"Social workers, all other",579542,103042,476500,46900,48407,46651
2018,"Probation officers and correctional treatment specialists",73177,34684,38493,50853,52638,49001
2018,"Social and human service assistants",169798,36420,133378,39864,41564,39143
2018,"Other community and social service specialists",61142,21224,39918,48450,55186,46049
2018,"Clergy",337060,286548,50512,48580,49843,42379
2018,"Directors, religious activities and education",48702,21913,26789,49998,55157,45587
2018,"Religious workers, all other",39320,19108,20212,38008,41153,35615
2018,"Legal Occupations:",1432935,709246,723689,92107,126800,69361
2018,"Lawyers",916470,584308,332162,129365,144950,110619
2018,"Judicial law clerks",12589,4842,7747,60166,75806,55366
2018,"Judges, magistrates, and other judicial workers",61581,34255,27326,109820,125080,82119
2018,"Paralegals and legal assistants",322319,47506,274813,51168,51484,51135
2018,"Title examiners, abstractors, and searchers",75755,22373,53382,48665,71888,44591
2018,"Legal support workers, all other",44221,15962,28259,57229,60750,56371
2018,"Educational Instruction, and Library Occupations:",5621630,1608658,4012972,51030,60158,48123
2018,"Postsecondary teachers",860445,452186,408259,74271,81085,67466
2018,"Preschool and kindergarten teachers",346550,9239,337311,26065,31008,25984
2018,"Elementary and middle school teachers",2573621,579313,1994308,52030,56630,51277
2018,"Secondary school teachers",523574,222481,301093,55629,58925,53942
2018,"Special education teachers",165556,26118,139438,50464,52821,50105
2018,"Tutors",21933,8141,13792,36938,41602,30406
2018,"Other teachers and instructors",367144,165188,201956,46851,52089,42246
2018,"Archivists, curators, and museum technicians",37717,14957,22760,53378,58441,51708
2018,"Librarians and media collections specialists",120808,24995,95813,52543,56210,52136
2018,"Library technicians",10537,2991,7546,32406,36459,31318
2018,"Teaching assistants",519137,83867,435270,24868,31800,23491
2018,"Other educational instruction and library workers",74608,19182,55426,57504,65750,55905
2018,"Arts, Design, Entertainment, Sports, and Media Occupations:",1937641,1076315,861326,55897,60227,51939
2018,"Artists and related workers",126347,77580,48767,51172,53709,46695
2018,"Commercial and industrial designers",15836,9111,6725,66220,68929,62110
2018,"Fashion designers",13728,3224,10504,57303,67350,52011
2018,"Floral designers",30600,6843,23757,30918,35510,30552
2018,"Graphic designers",224062,117886,106176,50717,52813,48854
2018,"Interior designers",65043,12910,52133,51408,56776,50827
2018,"Merchandise displayers and window trimmers",8913,4919,3994,31374,33750,29146
2018,"Other designers",277829,170083,107746,66468,71932,59509
2018,"Actors",17025,9751,7274,40057,49757,36241
2018,"Producers and directors",122159,75602,46557,66490,67634,65895
2018,"Athletes and sports competitors",24819,22253,2566,49383,48873,50353
2018,"Coaches and scouts",104434,72291,32143,48548,50416,45262
2018,"Umpires, referees, and other sports officials",3609,3313,296,50564,50602,50400
2018,"Dancers and choreographers",6846,2124,4722,41538,42235,40329
2018,"Music directors and composers",19299,15048,4251,52275,56728,50002
2018,"Musicians and singers",46476,35837,10639,40577,41210,35777
2018,"Disc jockeys, except radio",4587,4233,354,41391,45195,31283
2018,"Entertainers and performers, sports and related workers, all other",19177,12186,6991,44101,52055,35788
2018,"Broadcast announcers and radio disc jockeys",20126,14752,5374,46773,50140,45354
2018,"News analysts, reporters, and journalists",56971,34003,22968,55953,57044,52417
2018,"Public relations specialists",117307,43565,73742,71139,81412,66068
2018,"Editors",121293,56652,64641,60276,60951,59052
2018,"Technical writers",52526,22817,29709,74519,76992,72025
2018,"Writers and authors",144969,64619,80350,60644,68338,53315
2018,"Interpreters and translators",45860,15217,30643,42801,51981,40769
2018,"Court reporters and simultaneous captioners",21165,2405,18760,63656,73469,62813
2018,"Media and communication workers, all other",21581,10850,10731,52383,53534,51878
2018,"Broadcast, sound, and lighting technicians",65795,59752,6043,54076,55026,50589
2018,"Photographers",91478,55588,35890,42041,48393,31928
2018,"Television, video, and film camera operators and editors",43673,36945,6728,52255,52009,54474
2018,"Media and communication equipment workers, all other",4108,3956,152,57056,56914,86813
2018,"Healthcare Practitioners and Technical Occupations:",6988175,1885295,5102880,64326,81376,60940
2018,"Chiropractors",39195,30883,8312,74473,80330,59995
2018,"Dentists",102594,69160,33434,161845,180982,149310
2018,"Dietitians and nutritionists",71075,7095,63980,55150,56027,55061
2018,"Optometrists",29301,16295,13006,120142,129753,100852
2018,"Pharmacists",227504,102168,125336,122009,125508,120857
2018,"Other physicians",702010,440501,261509,203694,232350,180500
2018,"Physician assistants",99584,35581,64003,109275,122159,103570
2018,"Podiatrists",7975,6180,1795,153247,175559,120420
2018,"Audiologists",13023,2742,10281,75598,79359,75292
2018,"Occupational therapists",74105,12850,61255,72017,75076,71778
2018,"Physical therapists",188066,68855,119211,78350,82107,75803
2018,"Radiation therapists",12895,4126,8769,76589,82419,73804
2018,"Recreational therapists",8219,1761,6458,43210,44165,42733
2018,"Respiratory therapists",89450,33661,55789,59457,62387,55825
2018,"Speech-language pathologists",100526,4655,95871,65791,72802,65516
2018,"Exercise physiologists",3559,1361,2198,44019,37462,44331
2018,"Therapists, all other",117389,24625,92764,51092,54815,50580
2018,"Veterinarians",70086,26732,43354,100453,111080,93065
2018,"Registered nurses",2438923,322127,2116796,67380,72084,66871
2018,"Nurse anesthetists",23786,11012,12774,171095,192647,160778
2018,"Nurse practitioners",148670,16838,131832,102056,110015,101863
2018,"Acupuncturists",9537,3593,5944,52938,65823,51368
2018,"Healthcare diagnosing or treating practitioners, all other",6796,1960,4836,60422,61939,59183
2018,"Clinical laboratory technologists and technicians",252694,74920,177774,50401,52290,48519
2018,"Dental hygienists",87573,6147,81426,59095,75491,57432
2018,"Cardiovascular technologists and technicians",31550,11831,19719,47956,76643,39659
2018,"Diagnostic medical sonographers",65963,17428,48535,70691,78316,67368
2018,"Radiologic technologists and technicians",156224,53945,102279,56985,63795,54523
2018,"Magnetic resonance imaging technologists",35822,16852,18970,73210,80092,66526
2018,"Nuclear medicine technologists and medical dosimetrists",23130,10023,13107,97885,120279,90304
2018,"Emergency medical technicians",93185,57195,35990,36192,36888,34729
2018,"Paramedics",83950,63827,20123,54217,56320,50753
2018,"Pharmacy technicians",250158,49985,200173,32374,35261,31978
2018,"Psychiatric technicians",46946,15086,31860,34153,35620,32442
2018,"Surgical technologists",79351,23413,55938,46222,50324,45235
2018,"Veterinary technologists and technicians",91297,9740,81557,30820,31229,30766
2018,"Dietetic technicians and ophthalmic medical technicians",33482,6628,26854,26681,27416,26616
2018,"Licensed practical and licensed vocational nurses",633680,83863,549817,40500,42937,40245
2018,"Medical records specialists",146096,13082,133014,41346,40961,41377
2018,"Opticians, dispensing",46716,13202,33514,40548,49192,36793
2018,"Miscellaneous health technologists and technicians",108209,37612,70597,42292,48353,39780
2018,"Other healthcare practitioners and technical occupations",72862,26477,46385,51587,57799,50497
2018,"Healthcare Support Occupations:",3007586,468885,2538701,29848,32025,29172
2018,"Home health aides",247295,28010,219285,25710,28064,25492
2018,"Personal care aides",748466,139855,608611,26122,29478,25580
2018,"Nursing assistants",917699,113472,804227,28113,31476,27478
2018,"Orderlies and psychiatric aides",47802,27602,20200,30776,30848,30691
2018,"Occupational therapy assistants and aides",33800,5500,28300,42490,49258,41583
2018,"Physical therapist assistants and aides",58045,19631,38414,48022,51807,46237
2018,"Massage therapists",66268,18131,48137,31027,32211,30421
2018,"Dental assistants",182562,13920,168642,33905,35395,33828
2018,"Medical assistants",425145,35733,389412,31926,36928,31668
2018,"Medical transcriptionists",28687,4071,24616,30008,22970,30504
2018,"Pharmacy aides",23917,5566,18351,34793,46660,33026
2018,"Veterinary assistants and laboratory animal caretakers",32196,4875,27321,28040,33762,27247
2018,"Phlebotomists",88884,15717,73167,32613,35667,32237
2018,"Other healthcare support workers",106820,36802,70018,35711,36782,35036
2018,"Protective Service Occupations:",2641530,2094559,546971,51926,55696,42186
2018,"First-line supervisors of correctional officers",49858,36355,13503,52122,57000,43413
2018,"First-line supervisors of police and detectives",99874,85252,14622,82435,85573,71612
2018,"First-line supervisors of firefighting and prevention workers",43282,41051,2231,97455,97114,98401
2018,"First-line supervisors of security workers",68302,50152,18150,52195,54791,47042
2018,"First-line supervisors of protective service workers, all other",6981,6139,842,56482,55361,75426
2018,"Firefighters",277368,265873,11495,70142,70409,55852
2018,"Fire inspectors",21329,18572,2757,56366,58117,50487
2018,"Bailiffs",19385,12319,7066,56871,58238,53878
2018,"Correctional officers and jailers",344691,249597,95094,46263,49566,40323
2018,"Detectives and criminal investigators",117277,86774,30503,77548,83009,61780
2018,"Fish and game wardens",4515,3975,540,50014,50663,31530
2018,"Parking enforcement workers",6465,2783,3682,37293,40430,36434
2018,"Police officers",714910,613177,101733,66068,66997,59851
2018,"Animal control workers",8489,4989,3500,41442,41192,42538
2018,"Private detectives and investigators",83515,42623,40892,55998,62221,51191
2018,"Security guards and gambling surveillance officers",685467,524321,161146,32472,33396,30918
2018,"Crossing guards and flaggers",15889,8837,7052,39507,40938,37037
2018,"Transportation security screeners",35795,20437,15358,43539,43525,43553
2018,"School bus monitors",9488,1789,7699,18018,12741,18860
2018,"Other protective service workers",28650,19544,9106,32192,36240,30551
2018,"Food Preparation and Serving Related Occupations:",3887682,2042084,1845598,24999,26893,22344
2018,"Chefs and head cooks",367436,291021,76415,35249,36320,30455
2018,"First-line supervisors of food preparation and serving workers",414481,192077,222404,28084,32577,25154
2018,"Cooks",1243502,765137,478365,23166,25030,21264
2018,"Food preparation workers",368598,165923,202675,21922,23631,21107
2018,"Bartenders",229239,108603,120636,31324,35485,27915
2018,"Fast food and counter workers",151847,58381,93466,21189,21408,21095
2018,"Waiters and waitresses",777697,275654,502043,24599,27907,22577
2018,"Food servers, nonrestaurant",85109,33529,51580,25417,27478,23828
2018,"Dining room and cafeteria attendants and bartender helpers",85803,50388,35415,22206,24375,19948
2018,"Dishwashers",109979,87702,22277,21144,21239,20813
2018,"Hosts and hostesses, restaurant, lounge, and coffee shop",46317,9379,36938,21072,22577,20862
2018,"Food preparation and serving related workers, all other",7674,4290,3384,27489,26101,30277
2018,"Building and Grounds Cleaning and Maintenance Occupations:",3660938,2436867,1224071,28659,31697,23483
2018,"First-line supervisors of housekeeping and janitorial workers",193126,124769,68357,37720,42831,31008
2018,"First-line supervisors of landscaping, lawn service, and groundskeeping workers",131652,124325,7327,41667,41978,30532
2018,"Janitors and building cleaners",1667861,1216280,451581,30312,32356,24042
2018,"Maids and housekeeping cleaners",782088,124445,657643,23166,28212,22315
2018,"Pest control workers",67015,64687,2328,36568,36731,30995
2018,"Landscaping and groundskeeping workers",740972,707337,33635,27282,27330,26445
2018,"Tree trimmers and pruners",66480,64365,2115,34077,34584,18922
2018,"Other grounds maintenance workers",11744,10659,1085,32288,32546,30111
2018,"Personal Care and Service Occupations:",2089584,564375,1525209,27687,34453,26103
2018,"Supervisors of personal care and service workers",90716,35184,55532,39826,44725,35703
2018,"Animal trainers",32025,13759,18266,30607,38016,26245
2018,"Animal caretakers",143463,40422,103041,26733,30652,25783
2018,"Gambling services workers",70333,38687,31646,40751,42152,38312
2018,"Ushers, lobby attendants, and ticket takers",6782,3111,3671,21149,21490,20305
2018,"Other entertainment attendants and related workers",57855,32998,24857,28192,30630,25708
2018,"Embalmers, crematory operators and funeral attendants",9456,7232,2224,32211,37809,26444
2018,"Morticians, undertakers, and funeral arrangers",31038,21865,9173,52297,56731,43674
2018,"Barbers",81201,67879,13322,27979,28964,25672
2018,"Hairdressers, hairstylists, and cosmetologists",436499,47354,389145,27374,36156,26893
2018,"Manicurists and pedicurists",156859,31639,125220,22946,24999,22421
2018,"Skincare specialists",33708,573,33135,35942,12372,35956
2018,"Other personal appearance workers",11497,1819,9678,31241,36658,28351
2018,"Baggage porters, bellhops, and concierges",66519,47963,18556,35294,37191,30975
2018,"Tour and travel guides",22423,14907,7516,28712,30139,25942
2018,"Childcare workers",535622,29273,506349,22523,27291,22342
2018,"Exercise trainers and group fitness instructors",94335,48012,46323,36195,40020,34200
2018,"Recreation workers",100662,33188,67474,33521,40224,31298
2018,"Residential advisors",26891,9637,17254,31347,36693,28967
2018,"Personal care and service workers, all other",81700,38873,42827,30232,30699,29731
2018,"Sales and Related Occupations:",10130887,5893182,4237705,46617,54754,36519
2018,"First-Line supervisors of retail sales workers",2658713,1488859,1169854,42421,50319,36166
2018,"First-Line supervisors of non-retail sales workers",1127693,781633,346060,66701,70512,60284
2018,"Cashiers",1022881,301665,721216,22109,24477,21664
2018,"Counter and rental clerks",52689,33473,19216,35310,38325,28846
2018,"Parts salespersons",81106,71925,9181,37506,39174,31307
2018,"Retail salespersons",1714265,1050384,663881,35301,40600,29246
2018,"Advertising sales agents",119291,57762,61529,64676,67381,61471
2018,"Insurance sales agents",436274,223652,212622,52552,68818,45358
2018,"Securities, commodities, and financial services sales agents",201710,143408,58302,92142,109623,61816
2018,"Travel agents",49506,9956,39550,41838,45610,41285
2018,"Sales representatives of services, except advertising, insurance, financial services, and travel",565397,400572,164825,70325,74922,59564
2018,"Sales representatives, wholesale and manufacturing",1171414,860945,310469,67357,71573,58246
2018,"Models, demonstrators, and product promoters",12751,4339,8412,32997,45551,31787
2018,"Real estate brokers and sales agents",598051,285484,312567,60966,70710,51949
2018,"Sales engineers",35906,32195,3711,105524,110497,79723
2018,"Telemarketers",26295,9526,16769,27160,33050,25722
2018,"Door-to-door sales workers, news and street vendors, and related workers",50224,28217,22007,32588,36154,28384
2018,"Sales and related workers, all other",206721,109187,97534,56429,67511,50029
2018,"Office and Administrative Support Occupations:",12527103,3409297,9117806,39013,44296,37220
2018,"First-Line supervisors of office and administrative support workers",1134385,429283,705102,51626,60909,47857
2018,"Switchboard operators, including answering service",13931,2202,11729,33042,40896,32030
2018,"Telephone operators",21459,6344,15115,31801,39792,30999
2018,"Communications equipment operators, all other",12612,7056,5556,50353,51716,45222
2018,"Bill and account collectors",126263,37001,89262,36430,38903,35738
2018,"Billing and posting clerks",402466,49758,352708,36832,41528,36419
2018,"Bookkeeping, accounting, and auditing clerks",841994,116057,725937,40938,44997,40539
2018,"Gambling cage workers",4436,1455,2981,31637,36491,31183
2018,"Payroll and timekeeping clerks",131417,17203,114214,45365,50129,44749
2018,"Procurement clerks",43685,19879,23806,58008,63293,55198
2018,"Tellers",190229,28675,161554,28580,29581,28399
2018,"Financial clerks, all other",146980,65562,81418,63484,91573,51075
2018,"Brokerage clerks",8198,2061,6137,48439,51828,47055
2018,"Correspondence clerks",4911,1390,3521,41319,52285,31878
2018,"Court, municipal, and license clerks",61148,12720,48428,41455,48413,40026
2018,"Credit authorizers, checkers, and clerks",41108,12026,29082,42750,61737,39340
2018,"Customer service representatives",2035953,691550,1344403,35875,39259,34868
2018,"Eligibility interviewers, government programs",66286,14542,51744,43369,48188,41895
2018,"File clerks",122095,28632,93463,36964,40837,36406
2018,"Hotel, motel, and resort desk clerks",87856,32776,55080,24687,25718,24047
2018,"Interviewers, except eligibility and loan",77744,15418,62326,34978,39085,33767
2018,"Library assistants, clerical",30584,5934,24650,32411,35934,31562
2018,"Loan interviewers and clerks",116188,27165,89023,45519,50269,44775
2018,"New accounts clerks",14300,4074,10226,44460,50835,42880
2018,"Order clerks",86698,41513,45185,35308,38188,32449
2018,"Human resources assistants, except payroll and timekeeping",40401,8666,31735,41593,45924,41057
2018,"Receptionists and information clerks",694078,72701,621377,30226,32428,30003
2018,"Reservation and transportation ticket agents and travel clerks",93188,43305,49883,43800,46404,41036
2018,"Information and record clerks, all other",83360,20187,63173,41996,48594,40323
2018,"Cargo and freight agents",16693,11963,4730,41279,39579,46792
2018,"Couriers and messengers",164903,139234,25669,37381,39143,32258
2018,"Public safety telecommunicators",78326,24892,53434,41548,46824,40790
2018,"Dispatchers, except police, fire, and ambulance",162115,84654,77461,40252,45705,35193
2018,"Meter readers, utilities",19548,17922,1626,39107,39622,38438
2018,"Postal service clerks",100819,49236,51583,56120,59058,52031
2018,"Postal service mail carriers",281660,173392,108268,56497,58730,53608
2018,"Postal service mail sorters, processors, and processing machine operators",51588,26475,25113,54052,57065,50616
2018,"Production, planning, and expediting clerks",299389,127374,172015,50579,61664,42001
2018,"Shipping, receiving, and inventory clerks",485374,333956,151418,32701,34614,30801
2018,"Weighers, measurers, checkers, and samplers, recordkeeping",79429,44608,34821,36556,40634,33988
2018,"Executive secretaries and executive administrative assistants",174754,11778,162976,60100,59295,60122
2018,"Legal secretaries and administrative assistants",51196,2781,48415,48901,57961,48620
2018,"Medical secretaries and administrative assistants",43498,2618,40880,35391,40464,35130
2018,"Secretaries and administrative assistants, except legal, medical, and executive",1790070,108808,1681262,37710,42236,37442
2018,"Data entry keyers",212351,52510,159841,35169,36422,34421
2018,"Word processors and typists",175884,28316,147568,36950,40826,36482
2018,"Desktop publishers",1239,997,242,53664,54957,41889
2018,"Insurance claims and policy processing clerks",179113,40472,138641,40893,48844,39266
2018,"Mail clerks and mail machine operators, except postal service",43594,22731,20863,31504,33879,29940
2018,"Office clerks, general",939894,167839,772055,36231,40958,35628
2018,"Office machine operators, except computer",18913,8740,10173,32386,38124,30823
2018,"Proofreaders and copy markers",4601,1071,3530,45383,42028,45821
2018,"Statistical assistants",24262,12545,11717,53632,58914,50311
2018,"Office and administrative support workers, all other",393937,99250,294687,42160,47940,41095
2018,"Natural Resources, Construction, and Maintenance Occupations:",10852297,10398640,453657,42822,43592,33877
2018,"Farming, Fishing, and Forestry Occupations:",686487,558469,128018,30365,31411,22783
2018,"First-line supervisors of farming, fishing, and forestry workers",60475,53941,6534,45625,46075,36477
2018,"Agricultural inspectors",11009,7102,3907,47048,50279,44095
2018,"Animal breeders",5120,3414,1706,29532,33833,27952
2018,"Graders and sorters, agricultural products",35581,15110,20471,23923,29915,21236
2018,"Miscellaneous agricultural workers",505464,414607,90857,27802,30175,22118
2018,"Fishing and hunting workers",22447,20713,1734,41301,41500,32266
2018,"Forest and conservation workers",11613,9946,1667,41150,41518,34115
2018,"Logging workers",34778,33636,1142,35718,35988,32650
2018,"Construction and Extraction Occupations:",6166725,5983193,183532,41943,42023,37272
2018,"First-line supervisors of construction trades and extraction workers",735625,704159,31466,61337,61529,48279
2018,"Brickmasons, blockmasons, and stonemasons",101959,101492,467,39904,39741,75712
2018,"Carpenters",898872,882999,15873,38783,38987,32065
2018,"Carpet, floor, and tile installers and finishers",101981,100212,1769,35674,35807,25442
2018,"Cement masons, concrete finishers, and terrazzo workers",45338,44802,536,37369,37591,25385
2018,"Construction laborers",1398949,1356991,41958,35528,35550,34546
2018,"Construction equipment operators",304327,298869,5458,48241,48390,42085
2018,"Drywall installers, ceiling tile installers, and tapers",110556,108996,1560,35341,35422,30236
2018,"Electricians",693159,677748,15411,52131,52163,50376
2018,"Glaziers",31806,30948,858,40516,40611,34792
2018,"Insulation workers",34506,32387,2119,41977,42253,29339
2018,"Painters and paperhangers",400577,375216,25361,32131,32288,27738
2018,"Pipelayers",37631,37419,212,41291,41277,42434
2018,"Plumbers, pipefitters, and steamfitters",464360,456797,7563,48067,48108,44063
2018,"Plasterers and stucco masons",17365,16950,415,32227,32469,16425
2018,"Roofers",146814,143736,3078,32246,32136,46100
2018,"Sheet metal workers",98653,93246,5407,45618,45844,37889
2018,"Structural iron and steel workers",48405,47269,1136,51518,51598,40541
2018,"Solar photovoltaic installers",11248,10973,275,36991,37131,31468
2018,"Helpers, construction trades",22937,21510,1427,30408,30600,24842
2018,"Construction and building inspectors",74967,66061,8906,56973,59555,49716
2018,"Elevator and escalator installers and repairers",23681,23468,213,85512,85657,12064
2018,"Fence erectors",22431,22000,431,32583,32498,35808
2018,"Hazardous materials removal workers",22588,17853,4735,41385,44731,29490
2018,"Highway maintenance workers",81914,80364,1550,40728,40802,32917
2018,"Miscellaneous construction and related workers",32130,31283,847,40122,40453,23629
2018,"Derrick, rotary drill, and service unit operators, oil and gas",24901,24579,322,62911,62641,81373
2018,"Earth drillers, except oil and gas",20107,19798,309,50934,50936,27492
2018,"Explosives workers, ordnance handling experts, and blasters",6165,5927,238,49473,49748,41029
2018,"Underground mining machine operators",38637,37232,1405,63606,62418,77688
2018,"Other extraction workers",68477,66791,1686,58002,57462,71951
2018,"Installation, Maintenance, and Repair Occupations:",3999085,3856978,142107,48373,48691,42132
2018,"First-line supervisors of mechanics, installers, and repairers",243544,227699,15845,62485,63323,52424
2018,"Computer, automated teller, and office machine repairers",115787,104473,11314,46369,46758,41823
2018,"Radio and telecommunications equipment installers and repairers",143123,130867,12256,55951,56553,49043
2018,"Avionics technicians",12161,11151,1010,55760,58803,48482
2018,"Electric motor, power tool, and related repairers",18975,17930,1045,52457,54817,38493
2018,"Electrical and electronics repairers, industrial and utility",11750,11352,398,70065,70174,42692
2018,"Electronic equipment installers and repairers, motor vehicles",9239,9021,218,37358,37403,29741
2018,"Audiovisual equipment installers and repairers",24552,23517,1035,45032,45015,50495
2018,"Security and fire alarm systems installers",48936,47812,1124,47214,47156,51026
2018,"Aircraft mechanics and service technicians",147154,140268,6886,62156,62496,51774
2018,"Automotive body and related repairers",112802,110760,2042,44109,43827,54177
2018,"Automotive glass installers and repairers",13698,12998,700,37537,40021,27428
2018,"Automotive service technicians and mechanics",725033,711405,13628,39263,39342,34464
2018,"Bus and truck mechanics and diesel engine specialists",253806,248694,5112,48311,48493,41973
2018,"Heavy vehicle and mobile equipment service technicians and mechanics",250420,245904,4516,51595,51721,39139
2018,"Small engine mechanics",29209,28765,444,35242,35263,16061
2018,"Miscellaneous vehicle and mobile equipment mechanics, installers, and repairers",58493,57183,1310,31092,31001,40223
2018,"Control and valve installers and repairers",21837,20672,1165,58698,59622,50288
2018,"Heating, air conditioning, and refrigeration mechanics and installers",354142,349525,4617,47226,47317,38525
2018,"Home appliance repairers",30159,28880,1279,41838,42031,26584
2018,"Industrial and refractory machinery mechanics",309799,299409,10390,52051,52187,46412
2018,"Maintenance and repair workers, general",474005,457017,16988,46872,47190,39606
2018,"Maintenance workers, machinery",24815,23412,1403,55532,55588,46990
2018,"Millwrights",36536,35651,885,62287,62582,42494
2018,"Electrical power-line installers and repairers",100667,98200,2467,80185,80512,52429
2018,"Telecommunications line installers and repairers",116898,112957,3941,51911,51851,57688
2018,"Precision instrument and equipment repairers",47603,43246,4357,53748,56004,38639
2018,"Coin, vending, and amusement machine servicers and repairers",23204,19340,3864,37829,38772,36238
2018,"Commercial divers",2293,1893,400,50805,50584,51469
2018,"Locksmiths and safe repairers",24447,23307,1140,46292,46813,35929
2018,"Helpers--installation, maintenance, and repair workers",14841,13916,925,27108,27019,30302
2018,"Other installation, maintenance, and repair workers",181730,172630,9100,41199,41396,35242
2018,"Production Occupations:",7221510,5310063,1911447,39918,42766,30617
2018,"First-line supervisors of production and operating workers",846274,678572,167702,56964,60776,45061
2018,"Aircraft structure, surfaces, rigging, and systems assemblers",5576,3785,1791,45900,47494,42367
2018,"Electrical, electronics, and electromechanical assemblers",105864,54001,51863,32929,36038,30934
2018,"Engine and other machine assemblers",9926,8837,1089,44597,47597,34936
2018,"Structural metal fabricators and fitters",21536,20848,688,47275,47547,45528
2018,"Other assemblers and fabricators",818940,517868,301072,34277,36741,30686
2018,"Bakers",135250,60915,74335,27840,31363,25878
2018,"Butchers and other meat, poultry, and fish processing workers",191537,142046,49491,31572,33841,26382
2018,"Food and tobacco roasting, baking, and drying machine operators and tenders",9126,6437,2689,34980,35430,31884
2018,"Food batchmakers",57473,26427,31046,30786,37013,26774
2018,"Food cooking machine operators and tenders",9002,6434,2568,27888,29787,24421
2018,"Food processing workers, all other",127493,85318,42175,35060,36892,31160
2018,"Computer numerically controlled tool operators and programmers",98355,91245,7110,45567,46087,36900
2018,"Forming machine setters, operators, and tenders, metal and plastic",27505,24057,3448,42472,43547,29817
2018,"Cutting, punching, and press machine setters, operators, and tenders, metal and plastic",74260,61833,12427,35839,36829,30428
2018,"Grinding, lapping, polishing, and buffing machine tool setters, operators, and tenders, metal and plastic",37530,32981,4549,36655,37016,31857
2018,"Other machine tool setters, operators, and tenders, metal and plastic",11718,9962,1756,36081,36549,33295
2018,"Machinists",285821,274450,11371,49659,50167,34897
2018,"Metal furnace operators, tenders, pourers, and casters",18779,17952,827,46855,46811,47431
2018,"Model makers and patternmakers, metal and plastic",2876,2666,210,62485,63623,41667
2018,"Molders and molding machine setters, operators, and tenders, metal and plastic",30926,25748,5178,37733,39908,32571
2018,"Tool and die makers",50732,49369,1363,60940,61130,36383
2018,"Welding, soldering, and brazing workers",499832,473998,25834,42389,43238,32121
2018,"Other metal workers and plastic workers",377275,301781,75494,37678,40594,30654
2018,"Prepress technicians and workers",17807,11168,6639,41251,41542,40232
2018,"Printing press operators",127188,97360,29828,37372,41104,27486
2018,"Print binding and finishing workers",13610,8659,4951,36180,40070,30020
2018,"Laundry and dry-cleaning workers",106611,36540,70071,23483,28989,21930
2018,"Pressers, textile, garment, and related materials",21527,9642,11885,22921,27012,21498
2018,"Sewing machine operators",115211,34117,81094,26169,28745,25302
2018,"Shoe and leather workers",9146,7726,1420,27584,27766,27287
2018,"Tailors, dressmakers, and sewers",39045,13172,25873,28846,31016,28029
2018,"Textile machine setters, operators, and tenders",20036,10286,9750,28093,28369,27787
2018,"Upholsterers",22529,18621,3908,35992,38922,23964
2018,"Other textile, apparel, and furnishings workers",16178,8532,7646,33068,36062,30253
2018,"Cabinetmakers and bench carpenters",45202,42124,3078,36716,37327,30251
2018,"Furniture finishers",9563,8761,802,31026,33250,20931
2018,"Sawing machine setters, operators, and tenders, wood",25275,23201,2074,30338,30744,25863
2018,"Woodworking machine setters, operators, and tenders, except sawing",13284,11004,2280,30887,31682,27303
2018,"Other woodworkers",20977,19842,1135,38611,39634,26285
2018,"Power plant operators, distributors, and dispatchers",41965,39001,2964,97712,100421,67340
2018,"Stationary engineers and boiler operators",87786,84010,3776,62371,62126,73531
2018,"Water and wastewater treatment plant and system operators",83885,78704,5181,50999,51030,50663
2018,"Miscellaneous plant and system operators",40312,37753,2559,69631,70114,55814
2018,"Chemical processing machine setters, operators, and tenders",53074,47349,5725,49426,50243,46164
2018,"Crushing, grinding, polishing, mixing, and blending workers",66254,58944,7310,40388,40718,32296
2018,"Cutting workers",47559,38535,9024,31555,32763,25797
2018,"Extruding, forming, pressing, and compacting machine setters, operators, and tenders",21896,18583,3313,37483,38756,29741
2018,"Furnace, kiln, oven, drier, and kettle operators and tenders",8796,6593,2203,42568,56219,31474
2018,"Inspectors, testers, sorters, samplers, and weighers",685952,435039,250913,42693,50189,34935
2018,"Jewelers and precious stone and metal workers",26374,15897,10477,37878,41193,32376
2018,"Dental and ophthalmic laboratory technicians and medical appliance technicians",65104,32062,33042,40144,42107,36943
2018,"Packaging and filling machine operators and tenders",202961,95774,107187,29252,32031,26549
2018,"Painting workers",125009,111830,13179,39573,40246,31458
2018,"Photographic process workers and processing machine operators",17654,11903,5751,55573,60755,48029
2018,"Adhesive bonding machine operators and tenders",9061,6237,2824,31984,32247,28769
2018,"Etchers and engravers",5516,3460,2056,31488,33223,27952
2018,"Molders, shapers, and casters, except metal and plastic",25853,23134,2719,36941,37296,31511
2018,"Paper goods machine setters, operators, and tenders",16907,12171,4736,38814,42242,30187
2018,"Tire builders",11364,10272,1092,42213,45103,35692
2018,"Helpers--production workers",30689,23120,7569,29497,30710,24951
2018,"Other production equipment operators and tenders",9469,8030,1439,41602,43086,33141
2018,"Other production workers",1061275,773377,287898,35974,39470,29307
2018,"Transportation and Material Moving Occupations:",8119366,6745419,1373947,36551,39189,28339
2018,"Transportation Occupations:",4376399,3894093,482306,44469,46008,32858
2018,"Supervisors of transportation and material moving workers",265522,207618,57904,50604,52109,41468
2018,"Aircraft pilots and flight engineers",109135,103138,5997,110636,111576,85645
2018,"Air traffic controllers and airfield operations specialists",33578,25802,7776,79647,82124,65830
2018,"Flight attendants",58521,13461,45060,51072,60200,49786
2018,"Ambulance drivers and attendants, except emergency medical technicians",9683,7301,2382,30149,31818,25864
2018,"Bus drivers, school",96711,43624,53087,30050,32939,27079
2018,"Bus drivers, transit and intercity",179014,120182,58832,40815,45249,32714
2018,"Driver/sales workers and truck drivers",2877771,2724636,153135,45520,46192,31561
2018,"Shuttle drivers and chauffeurs",80079,67196,12883,31256,31965,25484
2018,"Taxi drivers",256971,228727,28244,30557,30929,25690
2018,"Motor vehicle operators, all other",63317,50177,13140,30390,32251,27111
2018,"Locomotive engineers and operators",42262,41145,1117,87257,87664,73401
2018,"Railroad conductors and yardmasters",47072,44341,2731,75022,75741,62104
2018,"Other rail transportation workers",18919,16668,2251,60153,60415,47298
2018,"Sailors and marine oilers",12921,11727,1194,51037,52457,38982
2018,"Ship and boat captains and operators",27148,25217,1931,71710,76112,60658
2018,"Parking attendants",48930,42068,6862,26059,26445,24141
2018,"Transportation service attendants",61105,54094,7011,27443,28790,23001
2018,"Transportation inspectors",43779,36572,7207,60094,66079,40093
2018,"Passenger attendants",15115,7251,7864,31982,39701,29988
2018,"Other transportation workers",25681,19983,5698,46631,46894,46151
2018,"Material Moving Occupations:",3742967,2851326,891641,30816,31792,26535
2018,"Crane and tower operators",55621,53214,2407,60121,60408,50890
2018,"Conveyor, dredge, and hoist and winch operators",14830,14207,623,45974,46464,34163
2018,"Industrial truck and tractor operators",528884,485246,43638,34419,34769,32097
2018,"Cleaners of vehicles and equipment",229102,194400,34702,26895,27158,25274
2018,"Laborers and freight, stock, and material movers, hand",1487821,1212468,275353,31638,32304,27293
2018,"Machine feeders and offbearers",23138,12777,10361,30354,32989,27586
2018,"Packers and packagers, hand",347044,152284,194760,25625,27234,24328
2018,"Stockers and order fillers",919060,603042,316018,28382,29601,26669
2018,"Pumping station operators",17520,17036,484,61310,61439,52041
2018,"Refuse and recyclable material collectors",65144,57895,7249,35819,36846,28879
2018,"Other material moving workers",54803,48757,6046,42039,45753,31733
2019,"Chief executives",1268017,932743,335274,150513,157133,120635
2019,"General and operations managers",1026798,685078,341720,72566,80489,61643
2019,"Legislators",12078,7266,4812,72354,77814,71119
2019,"Advertising and promotions managers",47962,20939,27023,81019,91634,72041
2019,"Marketing managers",462811,185926,276885,80596,95007,75432
2019,"Sales managers",494737,334121,160616,99456,106477,77087
2019,"Public relations and fundraising managers",84254,28038,56216,80613,88589,76776
2019,"Administrative services managers",56637,17489,39148,64213,76445,60398
2019,"Facilities managers",109054,90355,18699,70673,71641,61894
2019,"Computer and information systems managers",614170,437646,176524,112542,118104,101763
2019,"Financial managers",1207274,533586,673688,81468,102404,68737
2019,"Compensation and benefits managers",17663,4326,13337,82475,101196,81396
2019,"Human resources managers",239909,59647,180262,82113,95120,80175
2019,"Training and development managers",51405,23477,27928,77092,80200,74867
2019,"Industrial production managers",255384,197946,57438,81203,82295,72351
2019,"Purchasing managers",199161,100815,98346,80744,88888,73783
2019,"Transportation, storage, and distribution managers",254736,204652,50084,58586,59497,56225
2019,"Farmers, ranchers, and other agricultural managers",468808,411859,56949,42498,46000,32007
2019,"Construction managers",779567,716687,62880,77210,78521,67585
2019,"Education and childcare administrators",801378,285342,516036,73198,83924,67133
2019,"Architectural and engineering managers",167664,149081,18583,146705,147093,142245
2019,"Food service managers",831299,432632,398667,40280,45775,35417
2019,"Funeral home managers",7149,4520,2629,56017,66451,45318
2019,"Entertainment and recreation managers",31252,19178,12074,56527,62292,50514
2019,"Lodging managers",123830,60479,63351,51576,61950,45892
2019,"Medical and health services managers",611961,172451,439510,75556,88871,71282
2019,"Natural sciences managers",15582,6544,9038,86206,91559,82432
2019,"Postmasters and mail superintendents",25907,12918,12989,75172,80298,70511
2019,"Property, real estate, and community association managers",469549,223510,246039,56061,65809,50783
2019,"Social and community service managers",347489,104765,242724,60680,69624,57201
2019,"Emergency management directors",12432,7815,4617,72131,89610,54977
2019,"Personal service managers, all other",1777,458,1319,62153,100137,56102
2019,"Managers, all other",3770040,2428328,1341712,81086,90343,68884
2019,"Business and Financial Operations Occupations:",7130983,3317732,3813251,70234,80061,62437
2019,"Agents and business managers of artists, performers, and athletes",31236,19625,11611,66531,71625,55970
2019,"Buyers and purchasing agents, farm products",8191,6434,1757,55855,55835,60036
2019,"Wholesale and retail buyers, except farm products",148058,73781,74277,46212,45571,47091
2019,"Purchasing agents, except wholesale, retail, and farm products",249353,119709,129644,57633,61399,55160
2019,"Claims adjusters, appraisers, examiners, and investigators",310821,122774,188047,57095,65756,52257
2019,"Compliance officers",267175,125444,141731,70080,71591,67291
2019,"Cost estimators",134311,114132,20179,66724,70429,51396
2019,"Human resources workers",721077,178206,542871,61216,69952,59120
2019,"Compensation, benefits, and job analysis specialists",64873,14435,50438,58516,67307,56436
2019,"Training and development specialists",129863,57930,71933,60722,70273,54357
2019,"Logisticians",144009,93377,50632,53653,57995,49367
2019,"Project management specialists",589543,330922,258621,86829,91657,81250
2019,"Management analysts",726470,416513,309957,87256,95439,80978
2019,"Meeting, convention, and event planners",104821,25790,79031,51837,48050,53177
2019,"Fundraisers",64629,17970,46659,71979,78295,70435
2019,"Market research analysts and marketing specialists",275322,114274,161048,70326,77416,64915
2019,"Business operations specialists, all other",320774,144105,176669,65134,77146,57186
2019,"Accountants and auditors",1442414,596824,845590,70258,80288,64303
2019,"Property appraisers and assessors",76705,48064,28641,62871,70439,56134
2019,"Budget analysts",47888,18816,29072,80399,85902,75988
2019,"Credit analysts",33966,15441,18525,59580,69755,54013
2019,"Financial and investment analysts",256287,145420,110867,82194,86999,77723
2019,"Personal financial advisors",356802,251382,105420,100846,116105,73002
2019,"Insurance underwriters",108313,44314,63999,66251,77201,60410
2019,"Financial examiners",19044,9882,9162,80708,81979,80160
2019,"Credit counselors and loan officers",312507,135003,177504,62017,80064,54546
2019,"Tax examiners and collectors, and revenue agents",52223,19889,32334,55733,65036,51038
2019,"Tax preparers",47641,18777,28864,52421,62394,45106
2019,"Other financial specialists",86667,38499,48168,67805,99232,59726
2019,"Computer, Engineering, and Science Occupations:",8747777,6532159,2215618,84801,88755,75030
2019,"Computer and Mathematical Occupations:",4554097,3375006,1179091,87148,91377,77356
2019,"Computer and information research scientists",29036,20124,8912,115444,121128,102179
2019,"Computer systems analysts",541210,324263,216947,81998,89427,75628
2019,"Information security analysts",119961,97720,22241,100526,101763,86684
2019,"Computer programmers",286721,227137,59584,88133,90404,82351
2019,"Software developers",1470133,1204391,265742,111358,114190,101266
2019,"Software quality assurance analysts and testers",62927,35950,26977,77462,79116,75591
2019,"Web developers",79120,57266,21854,72754,76175,62340
2019,"Web and digital interface designers",50648,29451,21197,63645,65154,62292
2019,"Computer support specialists",564384,420458,143926,59893,60877,55112
2019,"Database administrators and architects",113267,77025,36242,90976,96930,70256
2019,"Network and computer systems administrators",204989,167734,37255,75994,76323,73211
2019,"Computer network architects",107703,99158,8545,96521,96066,101160
2019,"Computer occupations, all other",592121,437000,155121,66873,70029,61048
2019,"Actuaries",30007,18798,11209,121833,133788,101006
2019,"Mathematicians",3380,2441,939,126771,131394,94905
2019,"Operations research analysts",146923,75534,71389,82311,91362,75537
2019,"Statisticians",37709,18881,18828,94269,100273,92037
2019,"Other mathematical science occupations",113858,61675,52183,76480,78141,74189
2019,"Architecture and Engineering Occupations:",2889590,2449820,439770,86077,87639,76547
2019,"Architects, except landscape and naval",177231,132420,44811,87239,92818,72021
2019,"Landscape architects",25090,16522,8568,69063,71685,61693
2019,"Surveyors, cartographers, and photogrammetrists",30648,24732,5916,66424,70273,56659
2019,"Aerospace engineers",120118,105598,14520,110761,112402,101105
2019,"Agricultural engineers",2666,2283,383,91306,90716,93777
2019,"Bioengineers and biomedical engineers",12446,10368,2078,92598,94134,90990
2019,"Chemical engineers",69069,56392,12677,102493,105727,101296
2019,"Civil engineers",373633,317526,56107,90702,91923,79966
2019,"Computer hardware engineers",53377,45025,8352,101495,102060,90923
2019,"Electrical and electronics engineers",230750,210460,20290,101450,101802,92617
2019,"Environmental engineers",28423,19909,8514,84613,91027,80086
2019,"Industrial engineers, including health and safety",233006,187248,45758,85497,86334,80836
2019,"Marine engineers and naval architects",9426,8741,685,87524,86276,103672
2019,"Materials engineers",47988,41012,6976,87405,87936,82210
2019,"Mechanical engineers",296616,272658,23958,91119,91189,90524
2019,"Mining and geological engineers, including mining safety engineers",6948,6448,500,105597,110014,78145
2019,"Nuclear engineers",6437,5252,1185,111449,111834,105182
2019,"Petroleum engineers",25716,20704,5012,135549,138456,126712
2019,"Engineers, all other",531908,457152,74756,100779,101281,91932
2019,"Architectural and civil drafters",42570,35541,7029,54740,56781,46393
2019,"Other drafters",78663,63906,14757,56894,58064,50363
2019,"Electrical and electronic engineering technologists and technicians",96045,88713,7332,65019,65471,52401
2019,"Other engineering technologists and technicians, except drafters",333773,268665,65108,56233,60034,48180
2019,"Surveying and mapping technicians",57043,52545,4498,53158,53592,46654
2019,"Life, Physical, and Social Science Occupations:",1304090,707333,596757,71201,75732,66846
2019,"Agricultural and food scientists",26160,17526,8634,72569,76256,69856
2019,"Biological scientists",77736,38800,38936,68265,67687,68603
2019,"Conservation scientists and foresters",20035,14422,5613,61702,65489,58470
2019,"Medical scientists",121653,54981,66672,76684,81831,73907
2019,"Life scientists, all other",6218,3537,2681,70456,83521,62232
2019,"Astronomers and physicists",13025,11417,1608,121178,121691,72245
2019,"Atmospheric and space scientists",10162,7186,2976,79370,90894,58781
2019,"Chemists and materials scientists",98380,55717,42663,76785,85197,66645
2019,"Environmental scientists and specialists, including health",34279,20655,13624,67013,70862,63309
2019,"Geoscientists and hydrologists, except geographers",38013,28640,9373,92380,93523,90643
2019,"Physical scientists, all other",270593,152600,117993,85113,92369,76748
2019,"Economists",25524,16728,8796,120055,122372,102443
2019,"Survey researchers",2284,1109,1175,62157,76322,58285
2019,"Clinical and counseling psychologists",14421,3934,10487,96335,100441,96079
2019,"School psychologists",33240,5066,28174,71199,80856,70524
2019,"Other psychologists",94267,29864,64403,85411,98820,80629
2019,"Sociologists",3474,1362,2112,78381,76241,87539
2019,"Urban and regional planners",34300,20266,14034,79013,78409,79918
2019,"Miscellaneous social scientists and related workers",32574,18160,14414,71322,74452,67575
2019,"Agricultural and food science technicians",34910,22517,12393,50504,52062,46020
2019,"Biological technicians",21176,10180,10996,51294,52030,50278
2019,"Chemical technicians",60524,39590,20934,54646,56613,50723
2019,"Environmental science and geoscience technicians",15989,11259,4730,62034,65797,54883
2019,"Nuclear technicians",3301,2230,1071,86116,100736,36815
2019,"Social science research assistants",6191,2601,3590,51958,57742,51324
2019,"Other life, physical, and social science technicians",139917,70254,69663,46396,49080,43812
2019,"Occupational health and safety specialists and technicians",65744,46732,19012,67055,72319,58289
2019,"Education, Legal, Community Service, Arts, and Media Occupations:",11641414,4250685,7390729,53149,61996,50476
2019,"Community and Social Service Occupations:",2135382,745802,1389580,47751,49699,47043
2019,"Substance abuse and behavioral disorder counselors",88750,24017,64733,42210,40951,44139
2019,"Educational, guidance, and career counselors and advisors",271368,63280,208088,52143,51760,52226
2019,"Marriage and family therapists",21318,4893,16425,47200,50555,46136
2019,"Mental health counselors",85866,22396,63470,47419,48361,47244
2019,"Rehabilitation counselors",22369,8451,13918,50906,54863,48720
2019,"Counselors, all other",131603,47615,83988,43484,46527,42184
2019,"Child, family, and school social workers",57716,9972,47744,45914,47218,45370
2019,"Healthcare social workers",68427,16029,52398,49796,44289,51169
2019,"Mental health and substance abuse social workers",15840,3100,12740,60943,90166,60011
2019,"Social workers, all other",590916,105937,484979,48821,48632,48864
2019,"Probation officers and correctional treatment specialists",88471,40145,48326,51532,55208,49650
2019,"Social and human service assistants",176799,39630,137169,38851,42557,38040
2019,"Other community and social service specialists",70373,25582,44791,48076,47769,48131
2019,"Clergy",349811,293634,56177,50056,50686,46062
2019,"Directors, religious activities and education",50617,22424,28193,50019,52287,44829
2019,"Religious workers, all other",45138,18697,26441,37044,41898,35923
2019,"Legal Occupations:",1492512,715108,777404,96362,130503,71530
2019,"Lawyers",946723,591281,355442,131501,150220,115257
2019,"Judicial law clerks",16630,4466,12164,61223,61793,60739
2019,"Judges, magistrates, and other judicial workers",63837,32348,31489,105383,127453,88720
2019,"Paralegals and legal assistants",342756,47264,295492,51671,50610,51836
2019,"Title examiners, abstractors, and searchers",76681,25264,51417,51425,76600,46693
2019,"Legal support workers, all other",45885,14485,31400,50028,50717,48687
2019,"Educational Instruction, and Library Occupations:",6042723,1705554,4337169,51382,60576,48833
2019,"Postsecondary teachers",905983,474898,431085,72172,80052,66777
2019,"Preschool and kindergarten teachers",540060,14260,525800,30559,31149,30537
2019,"Elementary and middle school teachers",2064340,407312,1657028,52368,57041,51787
2019,"Secondary school teachers",918052,396335,521717,57033,60209,55665
2019,"Special education teachers",310161,49180,260981,53483,52245,53660
2019,"Tutors",22223,7990,14233,32474,33060,32365
2019,"Other teachers and instructors",384424,174057,210367,47556,57057,40967
2019,"Archivists, curators, and museum technicians",54516,26064,28452,59951,60872,58470
2019,"Librarians and media collections specialists",139287,25285,114002,54259,60622,52794
2019,"Library technicians",16383,4852,11531,33302,40229,31855
2019,"Teaching assistants",595135,102817,492318,24827,30505,23487
2019,"Other educational instruction and library workers",92159,22504,69655,60501,66194,59392
2019,"Arts, Design, Entertainment, Sports, and Media Occupations:",1970797,1084221,886576,56051,60198,52040
2019,"Artists and related workers",153698,94913,58785,49032,52779,41154
2019,"Commercial and industrial designers",12528,8546,3982,61231,60898,62655
2019,"Fashion designers",19226,3533,15693,71126,73837,70646
2019,"Floral designers",32768,4073,28695,28407,36699,26908
2019,"Graphic designers",236517,116992,119525,50546,52123,48187
2019,"Interior designers",69488,14694,54794,52478,60377,52074
2019,"Merchandise displayers and window trimmers",13230,5293,7937,40859,51730,31152
2019,"Other designers",260096,155594,104502,67298,71832,61711
2019,"Actors",14320,8639,5681,41114,41813,40489
2019,"Producers and directors",141910,86287,55623,71241,71790,70118
2019,"Athletes and sports competitors",26663,24261,2402,47373,47704,40649
2019,"Coaches and scouts",109599,74962,34637,47895,50244,45311
2019,"Umpires, referees, and other sports officials",3079,2801,278,39682,39699,32386
2019,"Dancers and choreographers",10780,2562,8218,35287,42383,30936
2019,"Music directors and composers",26624,21433,5191,51746,55861,44922
2019,"Musicians and singers",50740,40116,10624,42121,46095,38229
2019,"Disc jockeys, except radio",9150,8594,556,31625,31933,14460
2019,"Entertainers and performers, sports and related workers, all other",22482,13162,9320,33564,40967,28918
2019,"Broadcast announcers and radio disc jockeys",18670,14959,3711,55278,55542,52891
2019,"News analysts, reporters, and journalists",60194,32325,27869,61427,63251,59024
2019,"Public relations specialists",97027,36018,61009,72218,77795,68444
2019,"Editors",99317,45771,53546,62494,68177,60415
2019,"Technical writers",50273,22013,28260,75883,81825,71568
2019,"Writers and authors",130883,58209,72674,61189,65666,60049
2019,"Interpreters and translators",46569,14211,32358,43588,51225,40141
2019,"Court reporters and simultaneous captioners",20769,2070,18699,65691,100638,64614
2019,"Media and communication workers, all other",14890,7802,7088,64444,67342,59357
2019,"Broadcast, sound, and lighting technicians",65752,59853,5899,54843,54297,56218
2019,"Photographers",90433,53372,37061,44026,48370,40167
2019,"Television, video, and film camera operators and editors",61994,50147,11847,56475,59974,51125
2019,"Media and communication equipment workers, all other",1128,1016,112,71059,67164,97778
2019,"Healthcare Practitioners and Technical Occupations:",7181268,1970812,5210456,66614,85126,62299
2019,"Chiropractors",44485,33323,11162,75365,80030,62315
2019,"Dentists",114510,77891,36619,152233,167574,140040
2019,"Dietitians and nutritionists",70304,6865,63439,54338,56615,53875
2019,"Optometrists",32041,17767,14274,120503,131284,108797
2019,"Pharmacists",249804,113493,136311,122473,128130,121218
2019,"Physician assistants",107710,37766,69944,110834,121816,105676
2019,"Podiatrists",7568,5439,2129,144143,150911,135035
2019,"Audiologists",14517,2839,11678,81269,99122,80849
2019,"Occupational therapists",82325,10754,71571,72877,79798,72121
2019,"Physical therapists",192911,76599,116312,80762,85977,77337
2019,"Radiation therapists",12258,4206,8052,79974,80623,77526
2019,"Recreational therapists",10977,2632,8345,36331,35641,36406
2019,"Respiratory therapists",95448,35422,60026,60774,65518,58067
2019,"Speech-language pathologists",108405,6024,102381,66888,71411,66741
2019,"Exercise physiologists",4777,2043,2734,45873,47076,42457
2019,"Therapists, all other",115580,25429,90151,51889,53832,51628
2019,"Veterinarians",71009,25506,45503,101187,121405,95460
2019,"Registered nurses",2523490,336793,2186697,69754,73603,68509
2019,"Nurse anesthetists",33499,14105,19394,178784,182499,171149
2019,"Nurse practitioners",164509,19911,144598,104948,113546,103312
2019,"Acupuncturists",10792,4645,6147,55795,56868,51463
2019,"Healthcare diagnosing or treating practitioners, all other",4567,1445,3122,37946,15044,49186
2019,"Clinical laboratory technologists and technicians",262812,76287,186525,47169,48452,46840
2019,"Dental hygienists",90783,6467,84316,60521,73379,60287
2019,"Cardiovascular technologists and technicians",37324,15708,21616,55066,66510,50686
2019,"Diagnostic medical sonographers",68729,17128,51601,70908,85815,67244
2019,"Radiologic technologists and technicians",163506,57552,105954,57144,62255,54238
2019,"Magnetic resonance imaging technologists",38270,19080,19190,71373,78467,66369
2019,"Nuclear medicine technologists and medical dosimetrists",20000,10510,9490,90989,90113,95376
2019,"Emergency medical technicians",97157,58890,38267,36568,37011,35979
2019,"Paramedics",93642,66054,27588,56107,59454,52038
2019,"Pharmacy technicians",248368,59271,189097,33916,36409,32655
2019,"Psychiatric technicians",56330,17970,38360,34020,34830,33194
2019,"Surgical technologists",88156,25648,62508,45502,50890,42475
2019,"Veterinary technologists and technicians",104077,13464,90613,31639,32454,31523
2019,"Dietetic technicians and ophthalmic medical technicians",37474,6222,31252,28985,27235,29511
2019,"Licensed practical and licensed vocational nurses",518946,62232,456714,42180,47859,41851
2019,"Medical records specialists",160327,13845,146482,42724,42418,42756
2019,"Opticians, dispensing",52161,15736,36425,38783,51825,35033
2019,"Miscellaneous health technologists and technicians",114397,43689,70708,44690,50444,41498
2019,"Other healthcare practitioners and technical occupations",72581,26338,46243,55473,61136,52462
2019,"Healthcare Support Occupations:",3198658,490858,2707800,30473,32452,30163
2019,"Home health aides",279345,34885,244460,26250,27181,26124
2019,"Personal care aides",761338,140604,620734,26633,29454,26202
2019,"Nursing assistants",958206,106909,851297,29292,32262,28686
2019,"Orderlies and psychiatric aides",52510,27968,24542,31201,30443,32105
2019,"Occupational therapy assistants and aides",32776,5811,26965,45061,45234,44978
2019,"Physical therapist assistants and aides",74046,27032,47014,46938,49756,46197
2019,"Massage therapists",69997,16412,53585,35213,36568,34442
2019,"Dental assistants",202177,13511,188666,34049,39742,33630
2019,"Medical assistants",456251,44236,412015,32201,35855,32009
2019,"Medical transcriptionists",27044,4780,22264,30528,23392,31333
2019,"Pharmacy aides",24380,6098,18282,31593,43444,30116
2019,"Veterinary assistants and laboratory animal caretakers",36286,5327,30959,29219,33816,28242
2019,"Phlebotomists",98408,15507,82901,33910,36615,32845
2019,"Other healthcare support workers",125894,41778,84116,35248,40016,32320
2019,"Protective Service Occupations:",2744803,2171324,573479,54070,57824,42869
2019,"First-line supervisors of correctional officers",35106,25597,9509,60878,63619,54473
2019,"First-line supervisors of police and detectives",98715,84369,14346,89127,91124,78532
2019,"First-line supervisors of firefighting and prevention workers",48246,46141,2105,95517,95632,93750
2019,"First-line supervisors of security workers",68062,51220,16842,55262,56627,50313
2019,"First-line supervisors of protective service workers, all other",2750,2197,553,66257,66321,62137
2019,"Firefighters",297645,287333,10312,71600,71743,62394
2019,"Fire inspectors",24104,21121,2983,62126,62575,56508
2019,"Bailiffs",19555,12403,7152,54655,56076,52627
2019,"Correctional officers and jailers",353653,251850,101803,49724,52138,40609
2019,"Detectives and criminal investigators",143440,108647,34793,83327,90247,71459
2019,"Fish and game wardens",5325,4455,870,56638,56199,75170
2019,"Parking enforcement workers",7402,5031,2371,41407,41286,42164
2019,"Police officers",738767,629455,109312,67927,70132,60644
2019,"Animal control workers",8699,4805,3894,39328,39272,39399
2019,"Private detectives and investigators",82764,43362,39402,55050,59978,49728
2019,"Security guards and gambling surveillance officers",715456,539391,176065,32297,33540,30648
2019,"Crossing guards and flaggers",15518,10187,5331,30434,34425,26217
2019,"Transportation security screeners",39698,21783,17915,44393,44518,44244
2019,"School bus monitors",11623,2779,8844,25058,28750,24061
2019,"Other protective service workers",28275,19198,9077,35760,39272,30648
2019,"Food Preparation and Serving Related Occupations:",3965189,2074020,1891169,25694,27441,23440
2019,"Chefs and head cooks",409007,328921,80086,35152,36130,30819
2019,"First-line supervisors of food preparation and serving workers",385969,171062,214907,28989,32293,26723
2019,"Cooks",1279709,782667,497042,24423,25664,22228
2019,"Food preparation workers",391401,169621,221780,23341,24753,22324
2019,"Bartenders",241642,119247,122395,31583,35310,28810
2019,"Fast food and counter workers",166725,59635,107090,21335,21341,21331
2019,"Waiters and waitresses",744576,262362,482214,25216,29504,22598
2019,"Food servers, nonrestaurant",83694,28289,55405,25736,27271,24949
2019,"Dining room and cafeteria attendants and bartender helpers",95083,54973,40110,23743,25219,21564
2019,"Dishwashers",111948,85298,26650,21512,21793,20566
2019,"Hosts and hostesses, restaurant, lounge, and coffee shop",50082,8716,41366,21028,25275,20632
2019,"Food preparation and serving related workers, all other",5353,3229,2124,22391,24161,20853
2019,"Building and Grounds Cleaning and Maintenance Occupations:",3612735,2349404,1263331,29390,31831,24196
2019,"First-line supervisors of housekeeping and janitorial workers",206282,129321,76961,38904,45410,30410
2019,"First-line supervisors of landscaping, lawn service, and groundskeeping workers",133684,125323,8361,43509,45082,32086
2019,"Janitors and building cleaners",1575413,1122067,453346,30504,32169,25051
2019,"Maids and housekeeping cleaners",801736,121508,680228,23424,27364,22613
2019,"Pest control workers",72327,69541,2786,38938,39248,29690
2019,"Landscaping and groundskeeping workers",741974,702558,39416,28716,28949,25953
2019,"Tree trimmers and pruners",69993,68335,1658,36220,36270,31606
2019,"Other grounds maintenance workers",11326,10751,575,31328,31461,25085
2019,"Personal Care and Service Occupations:",2100017,578420,1521597,29636,33951,27066
2019,"Supervisors of personal care and service workers",98845,41519,57326,40670,45823,36307
2019,"Animal trainers",34038,12454,21584,31202,40397,26902
2019,"Animal caretakers",144411,37603,106808,27427,31922,26313
2019,"Gambling services workers",77663,40434,37229,40787,40732,40835
2019,"Ushers, lobby attendants, and ticket takers",10004,5627,4377,25298,26875,23675
2019,"Other entertainment attendants and related workers",66172,40251,25921,26873,29897,25633
2019,"Embalmers, crematory operators, and funeral attendants",6170,4031,2139,35226,35327,34511
2019,"Morticians, undertakers, and funeral arrangers",32854,22791,10063,52283,58605,44153
2019,"Barbers",80456,63373,17083,29283,30194,26254
2019,"Hairdressers, hairstylists, and cosmetologists",441881,48995,392886,30084,36915,29004
2019,"Manicurists and pedicurists",179563,39649,139914,24552,25869,23945
2019,"Skincare specialists",35774,964,34810,31776,34152,31698
2019,"Other personal appearance workers",12875,1584,11291,38826,39085,38719
2019,"Baggage porters, bellhops, and concierges",69647,50639,19008,35013,36761,31700
2019,"Tour and travel guides",21911,13406,8505,31442,34760,28055
2019,"Childcare workers",488187,25735,462452,23064,25474,22945
2019,"Exercise trainers and group fitness instructors",101160,56651,44509,36726,37133,36261
2019,"Recreation workers",103662,32662,71000,32488,37503,31516
2019,"Residential advisors",28752,10033,18719,33972,31909,35235
2019,"Personal care and service workers, all other",65992,30019,35973,29588,28383,30232
2019,"Sales and Related Occupations:",9988596,5710358,4278238,46454,54461,36458
2019,"First-Line supervisors of retail sales workers",2586031,1435872,1150159,42391,50270,36432
2019,"First-Line supervisors of non-retail sales workers",993841,653443,340398,63470,69054,56968
2019,"Cashiers",1042620,297898,744722,22460,24616,22032
2019,"Counter and rental clerks",56820,35642,21178,34625,38132,28505
2019,"Parts salespersons",105008,92261,12747,40365,41053,31901
2019,"Retail salespersons",1673056,1018068,654988,35903,41131,29896
2019,"Advertising sales agents",103843,48747,55096,67930,75437,61978
2019,"Insurance sales agents",495351,249954,245397,51647,66667,45095
2019,"Securities, commodities, and financial services sales agents",203862,148731,55131,94595,110316,65529
2019,"Travel agents",56365,12522,43843,42955,45213,42601
2019,"Sales representatives of services, except advertising, insurance, financial services, and travel",527903,362135,165768,70590,76584,58685
2019,"Sales representatives, wholesale and manufacturing",1156116,847543,308573,70044,72961,59382
2019,"Models, demonstrators, and product promoters",13630,5262,8368,32887,39432,26969
2019,"Real estate brokers and sales agents",643262,311958,331304,61192,71591,52429
2019,"Sales engineers",45876,41351,4525,121571,125063,91083
2019,"Telemarketers",25495,9617,15878,26440,31529,22974
2019,"Door-to-door sales workers, news and street vendors, and related workers",47986,26273,21713,31556,31980,31099
2019,"Sales and related workers, all other",211531,113081,98450,55462,70623,45856
2019,"Office and Administrative Support Occupations:",12078551,3204456,8874095,39299,43475,37457
2019,"First-Line supervisors of office and administrative support workers",930606,313684,616922,50776,59283,47222
2019,"Switchboard operators, including answering service",16562,3426,13136,33844,40660,32832
2019,"Telephone operators",26230,7166,19064,31099,43581,29492
2019,"Communications equipment operators, all other",7138,4147,2991,51999,60110,41781
2019,"Bill and account collectors",119725,31167,88558,37056,38978,36669
2019,"Billing and posting clerks",379418,50577,328841,37811,44192,37101
2019,"Bookkeeping, accounting, and auditing clerks",817933,108929,709004,41228,42204,41079
2019,"Gambling cage workers",10959,3196,7763,30752,34891,30171
2019,"Payroll and timekeeping clerks",122053,15983,106070,45638,50361,44925
2019,"Procurement clerks",36722,15718,21004,59228,66629,52277
2019,"Tellers",195977,33475,162502,30020,30807,29673
2019,"Financial clerks, all other",89984,35798,54186,54101,75321,48127
2019,"Brokerage clerks",7309,1494,5815,45393,80750,43556
2019,"Correspondence clerks",4003,1169,2834,45061,48359,39144
2019,"Court, municipal, and license clerks",71376,14736,56640,41667,45730,40769
2019,"Credit authorizers, checkers, and clerks",34560,9673,24887,44894,51529,42007
2019,"Customer service representatives",1925743,640682,1285061,36083,40396,34903
2019,"Eligibility interviewers, government programs",73327,11078,62249,43658,51609,42379
2019,"File clerks",100536,24277,76259,36466,39468,35894
2019,"Hotel, motel, and resort desk clerks",87970,33447,54523,25371,26251,24435
2019,"Interviewers, except eligibility and loan",124676,26129,98547,32490,35916,32163
2019,"Library assistants, clerical",37734,7883,29851,31853,36809,31014
2019,"Loan interviewers and clerks",110212,27865,82347,45558,49651,44613
2019,"New accounts clerks",14435,3154,11281,38787,42104,38072
2019,"Order clerks",74291,33049,41242,33738,35945,32857
2019,"Human resources assistants, except payroll and timekeeping",45673,8617,37056,44414,51432,43628
2019,"Receptionists and information clerks",783751,74719,709032,30656,33986,30464
2019,"Reservation and transportation ticket agents and travel clerks",104370,50740,53630,39534,45582,35409
2019,"Information and record clerks, all other",86333,17282,69051,37438,50432,35985
2019,"Cargo and freight agents",20710,14101,6609,41746,40627,45493
2019,"Couriers and messengers",211301,178625,32676,40128,41142,32967
2019,"Public safety telecommunicators",86913,28530,58383,45215,46497,43993
2019,"Dispatchers, except police, fire, and ambulance",155078,80341,74737,41731,50078,37025
2019,"Meter readers, utilities",17843,15331,2512,40140,40528,32386
2019,"Postal service clerks",112256,49159,63097,55917,60322,51428
2019,"Postal service mail carriers",287881,183551,104330,58486,60980,52770
2019,"Postal service mail sorters, processors, and processing machine operators",47475,23401,24074,49267,54901,46540
2019,"Production, planning, and expediting clerks",272346,127861,144485,51313,62139,45132
2019,"Shipping, receiving, and inventory clerks",508723,343569,165154,34564,35800,31758
2019,"Weighers, measurers, checkers, and samplers, recordkeeping",68608,36872,31736,36526,39636,33127
2019,"Executive secretaries and executive administrative assistants",219808,11534,208274,60394,64976,60235
2019,"Legal secretaries and administrative assistants",51042,2773,48269,51478,52307,51442
2019,"Medical secretaries and administrative assistants",58533,2362,56171,36114,35319,36123
2019,"Secretaries and administrative assistants, except legal, medical, and executive",1680344,103188,1577156,39913,44698,39572
2019,"Data entry keyers",188781,38937,149844,33954,36893,33264
2019,"Word processors and typists",31676,5047,26629,36218,46833,34786
2019,"Desktop publishers",1777,1183,594,48791,49489,44459
2019,"Insurance claims and policy processing clerks",174458,32158,142300,40211,44536,39496
2019,"Mail clerks and mail machine operators, except postal service",47591,24878,22713,31599,34803,28273
2019,"Office clerks, general",830235,139044,691191,35253,37959,34712
2019,"Office machine operators, except computer",25307,12469,12838,31197,32667,30437
2019,"Proofreaders and copy markers",6731,2213,4518,51454,62628,50264
2019,"Statistical assistants",23753,10134,13619,58497,60893,57406
2019,"Office and administrative support workers, all other",509775,127935,381840,42205,49217,41197
2019,"Natural Resources, Construction, and Maintenance Occupations:",11085254,10626018,459236,45217,45682,32398
2019,"Farming, Fishing, and Forestry Occupations:",637767,517415,120352,30463,31640,23252
2019,"First-line supervisors of farming, fishing, and forestry workers",42382,36857,5525,42287,44997,29427
2019,"Agricultural inspectors",10242,5945,4297,51003,51791,47435
2019,"Animal breeders",5443,3755,1688,35424,36281,25571
2019,"Graders and sorters, agricultural products",36052,13975,22077,24731,30100,22681
2019,"Miscellaneous agricultural workers",474301,390952,83349,29147,30697,22308
2019,"Fishing and hunting workers",20187,19391,796,41470,42009,25313
2019,"Forest and conservation workers",12379,10571,1808,34976,34557,35656
2019,"Logging workers",36781,35969,812,39023,39518,25506
2019,"Construction and Extraction Occupations:",6272018,6090679,181339,42942,43525,35282
2019,"First-line supervisors of construction trades and extraction workers",580040,562793,17247,61467,61744,41334
2019,"Brickmasons, blockmasons, and stonemasons",99782,98747,1035,40580,40622,30063
2019,"Carpenters",959403,941130,18273,40759,40873,31452
2019,"Carpet, floor, and tile installers and finishers",105629,101919,3710,37182,37241,34601
2019,"Cement masons, concrete finishers, and terrazzo workers",49606,49101,505,41536,41452,80599
2019,"Construction laborers",1342918,1299070,43848,35888,35966,32164
2019,"Construction equipment operators",321650,315281,6369,50243,50227,51319
2019,"Drywall installers, ceiling tile installers, and tapers",100136,97086,3050,35579,35831,27767
2019,"Electricians",811762,797331,14431,52959,53303,45195
2019,"Glaziers",38088,37683,405,42098,42154,39607
2019,"Insulation workers",40959,39490,1469,42461,43158,36430
2019,"Painters and paperhangers",409553,379190,30363,33965,34833,26043
2019,"Pipelayers",41942,40802,1140,42535,42597,32199
2019,"Plumbers, pipefitters, and steamfitters",509708,502480,7228,50451,50428,52515
2019,"Reinforcing iron and rebar workers",5934,5719,215,41222,40959,51427
2019,"Roofers",159082,155674,3408,35504,35657,22147
2019,"Sheet metal workers",115807,110591,5216,48466,49708,32828
2019,"Structural iron and steel workers",54870,54441,429,51405,51423,31650
2019,"Helpers, construction trades",28204,27704,500,30573,30486,31985
2019,"Construction and building inspectors",85478,77747,7731,60183,60858,50765
2019,"Elevator and escalator installers and repairers",27959,27459,500,91496,91921,66608
2019,"Fence erectors",21958,21771,187,37320,37438,35039
2019,"Hazardous materials removal workers",21595,16871,4724,40688,40200,42903
2019,"Highway maintenance workers",85521,81989,3532,41870,41981,39531
2019,"Septic tank servicers and sewer pipe cleaners",7071,6974,97,41718,42023,26250
2019,"Miscellaneous construction and related workers",25770,24482,1288,37454,37850,30362
2019,"Derrick, rotary drill, and service unit operators, oil and gas",20591,20059,532,70140,69567,85534
2019,"Earth drillers, except oil and gas",22015,21581,434,52313,52227,71389
2019,"Explosives workers, ordnance handling experts, and blasters",10652,10298,354,61445,62370,26702
2019,"Underground mining machine operators",44740,43771,969,62942,63541,25725
2019,"Other extraction workers",59169,57530,1639,54838,55760,22215
2019,"Installation, Maintenance, and Repair Occupations:",4175469,4017924,157545,50152,50347,41472
2019,"First-line supervisors of mechanics, installers, and repairers",220003,205076,14927,64517,65351,52684
2019,"Computer, automated teller, and office machine repairers",130423,119241,11182,46836,46837,46828
2019,"Radio and telecommunications equipment installers and repairers",138910,128620,10290,59565,60434,44829
2019,"Avionics technicians",15042,13329,1713,61926,64436,41719
2019,"Electric motor, power tool, and related repairers",22276,21034,1242,49823,51571,26165
2019,"Electrical and electronics installers and repairers, transportation equipment",2051,1681,370,43921,44825,29529
2019,"Electrical and electronics repairers, industrial and utility",13097,12403,694,70855,70748,80427
2019,"Electronic equipment installers and repairers, motor vehicles",7937,7107,830,41496,41418,41642
2019,"Audiovisual equipment installers and repairers",22578,20928,1650,44441,45633,30395
2019,"Security and fire alarm systems installers",50354,48782,1572,47434,48030,38465
2019,"Aircraft mechanics and service technicians",140687,134337,6350,67669,68810,50126
2019,"Automotive body and related repairers",124445,121008,3437,42760,43318,35186
2019,"Automotive glass installers and repairers",17501,16947,554,43053,42853,51712
2019,"Automotive service technicians and mechanics",742976,728127,14849,40814,40844,37022
2019,"Bus and truck mechanics and diesel engine specialists",269684,265769,3915,50691,50780,41711
2019,"Heavy vehicle and mobile equipment service technicians and mechanics",208008,205102,2906,55350,55541,41044
2019,"Small engine mechanics",36098,35321,777,37108,37278,27226
2019,"Miscellaneous vehicle and mobile equipment mechanics, installers, and repairers",63062,61754,1308,31613,31668,26948
2019,"Control and valve installers and repairers",19102,18171,931,62777,62361,81393
2019,"Heating, air conditioning, and refrigeration mechanics and installers",371923,366028,5895,50153,50229,44557
2019,"Home appliance repairers",35906,35492,414,41068,41055,45410
2019,"Industrial and refractory machinery mechanics",355822,341966,13856,55609,56059,40826
2019,"Maintenance and repair workers, general",568107,540045,28062,46852,47222,39321
2019,"Maintenance workers, machinery",25110,24361,749,52491,53267,32379
2019,"Millwrights",42486,41579,907,66112,66280,55123
2019,"Electrical power-line installers and repairers",107610,106425,1185,80579,80780,40276
2019,"Telecommunications line installers and repairers",125003,119082,5921,54352,53817,57202
2019,"Precision instrument and equipment repairers",47006,42605,4401,51994,55931,36699
2019,"Wind turbine service technicians",4244,4048,196,57332,57016,120672
2019,"Coin, vending, and amusement machine servicers and repairers",23788,21005,2783,39875,40982,30543
2019,"Commercial divers",2904,2554,350,61463,70032,25765
2019,"Locksmiths and safe repairers",21848,20725,1123,43745,44432,31758
2019,"Riggers",8380,7857,523,50845,51508,37403
2019,"Helpers--installation, maintenance, and repair workers",16639,15158,1481,27455,27019,31010
2019,"Other installation, maintenance, and repair workers",172009,161807,10202,41812,42063,35565
2019,"Production Occupations:",7324192,5351516,1972676,40136,43346,30856
2019,"First-line supervisors of production and operating workers",735945,588847,147098,56005,60086,43660
2019,"Aircraft structure, surfaces, rigging, and systems assemblers",4218,3180,1038,47956,51276,26583
2019,"Electrical, electronics, and electromechanical assemblers",110824,57685,53139,32678,36834,30596
2019,"Engine and other machine assemblers",10630,9605,1025,45456,46126,40509
2019,"Structural metal fabricators and fitters",21861,21135,726,46429,46563,41971
2019,"Other assemblers and fabricators",824113,521094,303019,35145,37321,31338
2019,"Bakers",145375,61934,83441,29241,32465,26157
2019,"Butchers and other meat, poultry, and fish processing workers",194279,148106,46173,31844,34541,27053
2019,"Food and tobacco roasting, baking, and drying machine operators and tenders",9499,7271,2228,33908,36140,29621
2019,"Food batchmakers",63719,29829,33890,30847,35599,27069
2019,"Food cooking machine operators and tenders",7577,4171,3406,24764,35361,22280
2019,"Food processing workers, all other",123068,83359,39709,36136,38141,30695
2019,"Computer numerically controlled tool operators and programmers",103394,95471,7923,47165,48679,36981
2019,"Forming machine setters, operators, and tenders, metal and plastic",34298,28512,5786,41671,45349,30579
2019,"Cutting, punching, and press machine setters, operators, and tenders, metal and plastic",71099,59878,11221,36838,38112,30700
2019,"Grinding, lapping, polishing, and buffing machine tool setters, operators, and tenders, metal and plastic",38790,33720,5070,38012,40598,27996
2019,"Other machine tool setters, operators, and tenders, metal and plastic",13403,11574,1829,38114,39407,28768
2019,"Machinists",328317,312592,15725,50440,50776,41163
2019,"Metal furnace operators, tenders, pourers, and casters",23012,20536,2476,50742,51443,37005
2019,"Model makers and patternmakers, metal and plastic",6462,5794,668,57273,59535,24144
2019,"Molders and molding machine setters, operators, and tenders, metal and plastic",34054,28595,5459,39865,42203,28465
2019,"Tool and die makers",55269,54422,847,58019,58378,47200
2019,"Welding, soldering, and brazing workers",539491,507458,32033,42703,44577,31859
2019,"Other metal workers and plastic workers",371172,284584,86588,37118,40247,30928
2019,"Prepress technicians and workers",17894,11624,6270,39918,44060,33870
2019,"Printing press operators",131701,104894,26807,40126,42465,28849
2019,"Print binding and finishing workers",12206,8301,3905,33975,36780,29189
2019,"Laundry and dry-cleaning workers",100981,35667,65314,23438,30249,21723
2019,"Pressers, textile, garment, and related materials",21471,10557,10914,25589,38843,21533
2019,"Sewing machine operators",111437,30331,81106,26430,29691,25516
2019,"Shoe and leather workers",9901,7478,2423,33387,32874,36381
2019,"Tailors, dressmakers, and sewers",43501,11564,31937,28660,30129,27813
2019,"Textile machine setters, operators, and tenders",20232,9147,11085,29225,29966,27276
2019,"Upholsterers",25300,21498,3802,33441,34038,31447
2019,"Other textile, apparel, and furnishings workers",13910,8226,5684,33090,32014,35068
2019,"Cabinetmakers and bench carpenters",45950,41587,4363,35910,36420,28690
2019,"Furniture finishers",8322,6588,1734,36256,37849,27096
2019,"Sawing machine setters, operators, and tenders, wood",25492,22145,3347,31076,31447,27073
2019,"Woodworking machine setters, operators, and tenders, except sawing",15665,13129,2536,31758,34429,27014
2019,"Other woodworkers",19858,18353,1505,34491,35038,31475
2019,"Power plant operators, distributors, and dispatchers",45913,41736,4177,99765,100961,65790
2019,"Stationary engineers and boiler operators",99828,94934,4894,70068,69323,81395
2019,"Water and wastewater treatment plant and system operators",91804,86650,5154,51550,51675,50747
2019,"Miscellaneous plant and system operators",41853,38808,3045,69894,70753,53507
2019,"Chemical processing machine setters, operators, and tenders",66532,58152,8380,51384,51861,46206
2019,"Crushing, grinding, polishing, mixing, and blending workers",84477,74270,10207,39444,40349,32332
2019,"Cutting workers",55836,44990,10846,31443,32081,26840
2019,"Extruding, forming, pressing, and compacting machine setters, operators, and tenders",21664,16833,4831,39133,41593,30507
2019,"Furnace, kiln, oven, drier, and kettle operators and tenders",8081,6809,1272,46865,49185,30788
2019,"Inspectors, testers, sorters, samplers, and weighers",665372,418301,247071,42163,49928,34626
2019,"Jewelers and precious stone and metal workers",33096,20265,12831,38171,41105,31690
2019,"Dental and ophthalmic laboratory technicians and medical appliance technicians",71994,33623,38371,38868,46739,35296
2019,"Packaging and filling machine operators and tenders",212342,96936,115406,30005,32283,27293
2019,"Painting workers",126089,112726,13363,41384,42118,31998
2019,"Photographic process workers and processing machine operators",20420,13523,6897,52739,56950,36858
2019,"Adhesive bonding machine operators and tenders",10175,6329,3846,35697,42084,25923
2019,"Etchers and engravers",6387,4330,2057,37258,40126,32689
2019,"Molders, shapers, and casters, except metal and plastic",24154,20225,3929,36015,37212,29411
2019,"Paper goods machine setters, operators, and tenders",20200,15618,4582,42545,51357,32943
2019,"Tire builders",11598,9934,1664,45897,48056,37775
2019,"Helpers--production workers",39451,29474,9977,31562,32321,30300
2019,"Other production equipment operators and tenders",10557,7909,2648,37152,40795,27565
2019,"Other production workers",1062679,758700,303979,37043,40772,30093
2019,"Transportation and Material Moving Occupations:",8237468,6827934,1409534,37188,40383,28923
2019,"Transportation Occupations:",4454627,3959754,494873,45487,46894,32462
2019,"Supervisors of transportation and material moving workers",237932,191253,46679,51291,53239,40954
2019,"Aircraft pilots and flight engineers",112215,107162,5053,120784,121458,100568
2019,"Air traffic controllers and airfield operations specialists",32764,27310,5454,100729,101586,75347
2019,"Flight attendants",62548,17871,44677,52385,56759,51471
2019,"Ambulance drivers and attendants, except emergency medical technicians",5851,4439,1412,32085,34155,28885
2019,"Bus drivers, school",112016,51284,60732,30307,31685,27824
2019,"Bus drivers, transit and intercity",189477,127256,62221,42321,46765,37170
2019,"Driver/sales workers and truck drivers",2886784,2726573,160211,46698,47377,32234
2019,"Shuttle drivers and chauffeurs",70225,60719,9506,31682,32077,28056
2019,"Taxi drivers",302507,260472,42035,30482,31314,22458
2019,"Motor vehicle operators, all other",90599,75423,15176,31585,32812,25908
2019,"Locomotive engineers and operators",41231,39893,1338,97848,99617,60289
2019,"Railroad conductors and yardmasters",45815,42703,3112,76685,77652,55128
2019,"Other rail transportation workers",20110,18230,1880,70139,70366,64786
2019,"Sailors and marine oilers",15920,15398,522,51881,52089,46841
2019,"Ship and boat captains and operators",27651,26272,1379,75096,76544,47317
2019,"Parking attendants",48503,42979,5524,27615,28310,23392
2019,"Transportation service attendants",67691,61220,6471,26636,26522,30253
2019,"Transportation inspectors",39582,34234,5348,61211,64476,41357
2019,"Passenger attendants",18770,6633,12137,27135,32328,22090
2019,"Other transportation workers",23576,19598,3978,46085,46877,44418
2019,"Material Moving Occupations:",3782841,2868180,914661,31293,32305,26999
2019,"Crane and tower operators",53520,51621,1899,60859,60978,50706
2019,"Conveyor, dredge, and hoist and winch operators",19617,18793,824,45371,45769,29869
2019,"Industrial truck and tractor operators",545613,502642,42971,35270,35544,31639
2019,"Cleaners of vehicles and equipment",238611,200604,38007,27690,28467,26163
2019,"Laborers and freight, stock, and material movers, hand",1517280,1223790,293490,32046,33340,28429
2019,"Machine feeders and offbearers",24955,15170,9785,30914,40944,24963
2019,"Packers and packagers, hand",343909,147771,196138,26673,30155,25360
2019,"Stockers and order fillers",891051,577896,313155,28530,29693,27097
2019,"Pumping station operators",19579,18814,765,61659,61670,48750
2019,"Refuse and recyclable material collectors",67240,59714,7526,31548,31607,31007
2019,"Other material moving workers",61466,51365,10101,39748,41876,25753
2020,"Chief executives",1157,794,363,124904,141024,106652
2020,"General and operations managers",983,702,281,75556,80132,64532
2020,"Marketing managers",483,199,284,79924,90064,74620
2020,"Sales managers",495,332,163,93288,98592,73372
2020,"Computer and information systems managers",703,516,187,104936,108732,99320
2020,"Financial managers",1228,603,624,77584,97760,64584
2020,"Human resources managers",264,70,194,85488,90896,83148
2020,"Industrial production managers",248,195,53,80600,82264,72904
2020,"Purchasing managers",221,123,98,80288,85072,74932
2020,"Transportation, storage, and distribution managers",266,212,55,50544,51428,49036
2020,"Construction managers",606,556,50,81900,82472,71136
2020,"Education and childcare administrators",846,286,560,76024,82680,72800
2020,"Food service managers",707,363,344,45604,52312,41132
2020,"Medical and health services managers",629,192,438,80860,95628,76128
2020,"Property, real estate, and community association managers",433,209,224,59280,61464,56472
2020,"Social and community service managers",330,90,240,64168,82160,60476
2020,"Managers, all other",3120,1821,1299,81328,90948,71708
2020,"Business and financial operations occupations",7294,3312,3982,70876,80600,62868
2020,"Wholesale and retail buyers, except farm products",130,64,66,54756,54444,55432
2020,"Purchasing agents, except wholesale, retail, and farm products",219,106,113,64012,72124,59176
2020,"Claims adjusters, appraisers, examiners, and investigators",325,122,203,57616,69472,50284
2020,"Compliance officers",286,119,167,71344,71396,71292
2020,"Human resources workers",739,185,553,65052,75036,61048
2020,"Logisticians",134,84,50,60996,65312,59280
2020,"Project management specialists",644,350,295,81120,88036,76336
2020,"Management analysts",658,384,273,84708,96512,75660
2020,"Market research analysts and marketing specialists",358,145,212,68952,83616,62296
2020,"Business operations specialists, all other",271,126,144,66196,80080,56472
2020,"Accountants and auditors",1488,595,893,67496,79040,61672
2020,"Financial and investment analysts",310,182,128,82680,90584,77376
2020,"Personal financial advisors",400,251,149,85176,98800,67132
2020,"Credit counselors and loan officers",391,169,222,62348,77584,52676
2020,"Computer and mathematical occupations",5083,3838,1246,84916,90376,73996
2020,"Computer systems analysts",529,353,175,78780,84292,73476
2020,"Computer programmers",388,307,82,85956,86996,79508
2020,"Software developers",1742,1420,322,99840,104208,89856
2020,"Computer support specialists",584,427,157,59644,60476,56940
2020,"Computer occupations, all other",716,517,199,72488,75712,60372
2020,"Operations research analysts",154,81,73,83980,92872,75920
2020,"Architecture and engineering occupations",2933,2466,467,81900,84552,71864
2020,"Civil engineers",370,317,54,83772,84708,82576
2020,"Engineers, all other",543,460,83,90792,91468,76076
2020,"Other engineering technologists and technicians, except drafters",340,275,65,58188,61672,46800
2020,"Life, physical, and social science occupations",1401,735,666,69472,75400,62504
2020,"Medical scientists",114,53,60,83824,109356,71344
2020,"Physical scientists, all other",324,175,149,74776,89856,68900
2020,"Other life, physical, and social science technicians",202,90,111,55848,58032,54444
2020,"Community and social service occupations",2187,703,1484,52156,57356,50752
2020,"Educational, guidance, and career counselors and advisors",294,72,222,56160,58916,55172
2020,"Social workers, all other",593,84,509,51220,60840,50544
2020,"Probation officers and correctional treatment specialists",111,53,58,55016,62556,50804
2020,"Clergy",353,292,61,54860,58812,44616
2020,"Legal occupations",1410,599,812,80080,118300,65104
2020,"Lawyers",821,470,351,109044,120848,86580
2020,"Education, training, and library occupations",7012,1870,5142,56992,69004,53352
2020,"Postsecondary teachers",891,443,448,78832,84916,71968
2020,"Elementary and middle school teachers",3064,634,2430,58136,65416,56420
2020,"Secondary school teachers",914,383,530,62348,68588,59748
2020,"Special education teachers",301,58,244,54288,57304,53872
2020,"Other teachers and instructors",376,145,231,55172,68328,48984
2020,"Teaching assistants",714,123,591,32084,38064,31408
2020,"Arts, design, entertainment, sports, and media occupations",1681,877,804,61308,65104,58656
2020,"Graphic designers",209,91,119,63960,72540,59280
2020,"Other designers",271,170,101,62920,64168,57564
2020,"Producers and directors",123,63,60,77948,75816,80496
2020,"Healthcare practitioners and technical occupations",7504,1921,5584,63804,78312,59956
2020,"Pharmacists",241,108,134,115544,118872,112320
2020,"Other physicians",752,439,313,109304,120172,99060
2020,"Physical therapists",209,74,135,76336,82732,75452
2020,"Registered nurses",2701,364,2337,65624,75608,64480
2020,"Clinical laboratory technologists and technicians",289,78,211,53456,62140,49192
2020,"Radiologic technologists and technicians",222,77,145,57356,64168,55276
2020,"Pharmacy technicians",257,58,199,37596,42328,36400
2020,"Licensed practical and licensed vocational nurses",500,55,445,45500,50128,44928
2020,"Miscellaneous health technologists and technicians",143,51,93,46176,58240,42900
2020,"Healthcare support occupations",3210,532,2678,31512,33280,31200
2020,"Personal care aides",788,176,612,28236,29484,27924
2020,"Nursing assistants",966,115,851,30940,35828,30576
2020,"Other healthcare support workers",124,51,73,35464,38376,31980
2020,"Protective service occupations",2690,2080,610,51064,54236,39936
2020,"Correctional officers and jailers",337,225,112,47164,55796,38636
2020,"Police officers",742,611,131,60060,61776,55848
2020,"Security guards and gambling surveillance officers",673,503,170,33800,35360,30316
2020,"Food preparation and serving related occupations",3353,1700,1653,27560,29640,26312
2020,"Chefs and head cooks",321,263,57,36192,36764,31876
2020,"First-line supervisors of food preparation and serving workers",335,137,198,31304,33072,30316
2020,"Cooks",1026,610,416,26520,26624,26260
2020,"Food preparation workers",355,132,224,26520,29952,25428
2020,"Bartenders",169,99,70,33696,36816,30420
2020,"Fast food and counter workers",231,84,146,24336,24024,24440
2020,"Waiters and waitresses",600,212,388,26728,29276,25844
2020,"Building and grounds cleaning and maintenance occupations",3138,2051,1087,31356,33852,26572
2020,"First-line supervisors of housekeeping and janitorial workers",171,107,64,38376,46904,30992
2020,"Janitors and building cleaners",1372,925,447,31928,34424,27144
2020,"Maids and housekeeping cleaners",629,98,531,26156,28912,25844
2020,"Personal care and service occupations",1380,376,1004,32032,38480,30732
2020,"Sales and related occupations",8958,4991,3967,45760,54392,37180
2020,"First-line supervisors of retail sales workers",2141,1181,960,44616,51012,38116
2020,"First-line supervisors of non-retail sales workers",783,510,273,63752,69576,55952
2020,"Cashiers",1088,284,805,26364,27248,26052
2020,"Retail salespersons",1603,992,611,36660,40508,31356
2020,"Advertising sales agents",120,50,69,55432,62348,54860
2020,"Insurance sales agents",469,226,242,48412,60788,42900
2020,"Sales representatives of services, except advertising, insurance, financial services, and travel",497,333,163,70252,77064,57252
2020,"Sales representatives, wholesale and manufacturing",1073,758,315,66300,71656,55380
2020,"Real estate brokers and sales agents",498,215,283,56368,70304,48724
2020,"Sales and related workers, all other",206,100,106,49400,54028,43576
2020,"Office and administrative support occupations",12207,3445,8762,40612,45136,39312
2020,"First-line supervisors of office and administrative support workers",1129,395,734,50232,59540,48100
2020,"Bookkeeping, accounting, and auditing clerks",741,105,636,42848,57252,42068
2020,"Customer service representatives",1814,655,1160,37492,40092,36296
2020,"Receptionists and information clerks",846,108,738,33384,35776,33072
2020,"Couriers and messengers",340,284,55,40508,42328,36452
2020,"Dispatchers, except police, fire, and ambulance",178,84,95,39936,47216,37284
2020,"Postal service mail carriers",290,185,104,52884,56628,50024
2020,"Production, planning, and expediting clerks",243,118,125,55744,63804,47216
2020,"Shipping, receiving, and inventory clerks",505,340,165,36192,37076,34684
2020,"Secretaries and administrative assistants, except legal, medical, and executive",1607,112,1496,40612,48308,40404
2020,"Data entry keyers",180,51,128,36920,41756,36400
2020,"Office clerks, general",912,153,759,38272,41080,37752
2020,"Office and administrative support workers, all other",437,107,330,45084,43472,45500
2020,"Natural resources, construction, and maintenance occupations",10690,10152,538,47060,47684,35464
2020,"Farming, fishing, and forestry occupations",787,600,187,30628,31616,27456
2020,"Miscellaneous agricultural workers",628,491,137,29848,30628,26988
2020,"Construction and extraction occupations",5826,5635,191,47112,47320,41392
2020,"Installation, maintenance, and repair occupations",4077,3917,160,51168,51532,41652
2020,"Production occupations",6820,5055,1765,40300,43732,32760
2020,"First-line supervisors of production and operating workers",713,591,122,53976,57148,42432
2020,"Other assemblers and fabricators",828,565,263,36660,38480,33176
2020,"Bakers",131,53,78,30992,32292,30368
2020,"Butchers and other meat, poultry, and fish processing workers",221,163,57,38116,39208,33384
2020,"Other metal workers and plastic workers",338,277,61,40040,42432,32344
2020,"Inspectors, testers, sorters, samplers, and weighers",684,418,266,42328,47320,36920
2020,"Packaging and filling machine operators and tenders",224,126,98,32240,34684,28288
2020,"Other production workers",957,706,251,38428,41496,33124
2020,"Transportation and material moving occupations",7917,6439,1478,37388,39468,31200
2020,"Bus drivers, school",105,52,53,33644,36816,32344
2020,"Bus drivers, transit and intercity",146,89,57,40716,40248,41132
2020,"Driver/sales workers and truck drivers",2592,2409,183,46592,47632,34632
2020,"Laborers and freight, stock, and material movers, hand",1587,1268,319,33800,34944,30940
2020,"Packers and packagers, hand",436,205,231,30264,31408,28288
2020,"Stockers and order fillers",1058,714,345,30836,31304,29952
2021,"Chief executives",1316312,950742,365570,154737,166279,125741
2021,"General and operations managers",1050155,690934,359221,77771,85730,65378
2021,"Legislators",12709,7007,5702,76241,81767,70896
2021,"Advertising and promotions managers",57735,27035,30700,86690,97919,77910
2021,"Marketing managers",472097,181401,290696,89611,103449,82701
2021,"Sales managers",493815,338126,155689,104544,120036,81736
2021,"Public relations and fundraising managers",87998,27717,60281,84268,94687,79816
2021,"Administrative services managers",59654,14792,44862,70082,85238,65351
2021,"Facilities managers",113303,88009,25294,71507,74236,62902
2021,"Computer and information systems managers",602769,437564,165205,121987,126210,108483
2021,"Financial managers",1312143,577638,734505,86565,109157,72352
2021,"Compensation and benefits managers",15987,3974,12013,89123,94019,86446
2021,"Human resources managers",238400,53663,184737,91316,110404,86815
2021,"Training and development managers",57518,26063,31455,82905,88756,78426
2021,"Industrial production managers",251921,194058,57863,86033,87448,82993
2021,"Purchasing managers",210141,106198,103943,84861,96864,75269
2021,"Transportation, storage, and distribution managers",271367,220386,50981,62109,62267,61105
2021,"Farmers, ranchers, and other agricultural managers",468451,410552,57899,46682,50048,35117
2021,"Construction managers",818830,756526,62304,79863,80373,73412
2021,"Education and childcare administrators",850511,294482,556029,77770,89213,72059
2021,"Architectural and engineering managers",205299,180544,24755,151759,152191,147036
2021,"Food service managers",681416,366733,314683,43691,50706,38976
2021,"Funeral home managers",7360,5086,2274,50966,52489,37159
2021,"Entertainment and recreation managers",34014,20390,13624,57389,61929,54423
2021,"Lodging managers",83060,42316,40744,52097,59090,47781
2021,"Medical and health services managers",681440,194333,487107,79236,93135,75493
2021,"Natural sciences managers",23243,9128,14115,79555,96586,75936
2021,"Postmasters and mail superintendents",25146,10640,14506,75590,78681,73840
2021,"Property, real estate, and community association managers",445516,203965,241551,61812,75430,54458
2021,"Social and community service managers",391175,112409,278766,63934,73302,61624
2021,"Emergency management directors",14160,10151,4009,75328,77892,60336
2021,"Personal service managers, all other",39246,11106,28140,44871,52758,38191
2021,"Managers, all other",3776173,2382407,1393766,88771,97904,76803
2021,"Business and Financial Operations Occupations:",7748685,3611239,4137446,75831,85910,67890
2021,"Agents and business managers of artists, performers, and athletes",27254,14400,12854,80223,94319,69624
2021,"Buyers and purchasing agents, farm products",7767,5585,2182,59982,62361,51395
2021,"Wholesale and retail buyers, except farm products",134002,69328,64674,49148,50367,46933
2021,"Purchasing agents, except wholesale, retail, and farm products",247428,119109,128319,63906,69135,60479
2021,"Claims adjusters, appraisers, examiners, and investigators",327468,129010,198458,60679,67945,54802
2021,"Compliance officers",276458,121349,155109,76144,79813,73141
2021,"Cost estimators",130122,110306,19816,72745,76066,54780
2021,"Human resources workers",791658,195816,595842,66204,77575,63568
2021,"Compensation, benefits, and job analysis specialists",63010,15524,47486,60826,79269,57061
2021,"Training and development specialists",142352,65203,77149,64227,71837,59215
2021,"Logisticians",151929,98972,52957,59461,62382,53588
2021,"Project management specialists",733680,410043,323637,94639,100890,88411
2021,"Management analysts",778105,441133,336972,95700,102937,87629
2021,"Meeting, convention, and event planners",77913,18368,59545,55852,55687,55912
2021,"Fundraisers",63893,17874,46019,77598,85134,76230
2021,"Market research analysts and marketing specialists",304723,125074,179649,72540,81204,67571
2021,"Business operations specialists, all other",498533,214271,284262,67373,80204,60982
2021,"Accountants and auditors",1452102,614573,837529,75713,84537,69691
2021,"Property appraisers and assessors",76284,49827,26457,70228,84166,52168
2021,"Budget analysts",52562,23079,29483,77798,87652,72153
2021,"Credit analysts",32720,16664,16056,64200,74293,58884
2021,"Financial and investment analysts",308186,179257,128929,91177,98212,84410
2021,"Personal financial advisors",369329,256169,113160,104506,127351,79830
2021,"Insurance underwriters",115272,40608,74664,73416,82580,68168
2021,"Financial examiners",21995,8861,13134,77077,83193,67085
2021,"Credit counselors and loan officers",355144,160732,194412,73589,95758,60424
2021,"Tax examiners and collectors, and revenue agents",57619,19259,38360,56182,66883,50110
2021,"Tax preparers",52019,22692,29327,56313,65542,51768
2021,"Other financial specialists",99158,48153,51005,78146,101339,63562
2021,"Computer, Engineering, and Science Occupations:",9540113,7130087,2410026,90974,94701,80406
2021,"Computer and Mathematical Occupations:",5029627,3776648,1252979,94409,99619,83834
2021,"Computer and information research scientists",22546,16075,6471,104855,119487,89702
2021,"Computer systems analysts",513719,315855,197864,86616,92841,79958
2021,"Information security analysts",166397,137610,28787,105253,106706,97070
2021,"Computer programmers",282641,231972,50669,96352,97737,90806
2021,"Software developers",1654896,1368380,286516,121001,122738,110053
2021,"Software quality assurance analysts and testers",79361,43332,36029,86049,86583,85263
2021,"Web developers",86689,65720,20969,79457,83258,74106
2021,"Web and digital interface designers",55762,28902,26860,71545,73180,69049
2021,"Computer support specialists",617695,466754,150941,62807,64419,58043
2021,"Database administrators and architects",118125,80717,37408,97535,103882,73703
2021,"Network and computer systems administrators",206897,173048,33849,80656,81789,73457
2021,"Computer network architects",105013,98848,6165,102372,101989,110609
2021,"Computer occupations, all other",653248,490772,162476,75477,76520,71913
2021,"Actuaries",33962,25529,8433,129791,135774,124509
2021,"Mathematicians",3177,2186,991,108699,126941,73189
2021,"Operations research analysts",150508,74745,75763,87588,96322,80221
2021,"Statisticians",34888,16667,18221,94963,96142,93533
2021,"Other mathematical science occupations",244103,139536,104567,89573,95859,82723
2021,"Architecture and Engineering Occupations:",3056719,2569629,487090,91429,93381,81303
2021,"Architects, except landscape and naval",182912,132865,50047,93034,98410,81870
2021,"Landscape architects",27829,18332,9497,71561,72768,69880
2021,"Surveyors, cartographers, and photogrammetrists",29210,25958,3252,72466,73849,54775
2021,"Aerospace engineers",136375,119506,16869,112150,115374,100540
2021,"Agricultural engineers",3189,2963,226,80375,85865,71875
2021,"Bioengineers and biomedical engineers",17418,13239,4179,81832,84302,76582
2021,"Chemical engineers",83484,68464,15020,112416,113936,106216
2021,"Civil engineers",389295,324809,64486,94264,96553,83530
2021,"Computer hardware engineers",61579,54509,7070,117413,119162,104955
2021,"Electrical and electronics engineers",246368,223154,23214,106087,108183,94247
2021,"Environmental engineers",33048,22071,10977,93150,94565,90082
2021,"Industrial engineers, including health and safety",243012,183632,59380,88525,89879,84702
2021,"Marine engineers and naval architects",14537,13428,1109,87123,85656,90866
2021,"Materials engineers",41019,36051,4968,93027,93717,83151
2021,"Mechanical engineers",293999,268461,25538,95588,96419,91685
2021,"Mining and geological engineers, including mining safety engineers",4994,4285,709,101563,106992,66622
2021,"Nuclear engineers",8105,7025,1080,103529,114019,69392
2021,"Petroleum engineers",18403,16623,1780,153574,156102,124003
2021,"Engineers, all other",612278,525840,86438,103913,104517,97849
2021,"Architectural and civil drafters",44262,34302,9960,58834,59487,56078
2021,"Other drafters",81224,68212,13012,62019,64621,51382
2021,"Electrical and electronic engineering technologists and technicians",83199,75826,7373,69976,71150,59860
2021,"Other engineering technologists and technicians, except drafters",340765,273473,67292,61829,65524,50379
2021,"Surveying and mapping technicians",60215,56601,3614,56467,56324,60079
2021,"Life, Physical, and Social Science Occupations:",1453767,783810,669957,76012,80169,72227
2021,"Agricultural and food scientists",27595,19376,8219,76201,80250,66936
2021,"Biological scientists",80729,41771,38958,74182,75715,73073
2021,"Conservation scientists and foresters",25269,19936,5333,64464,65896,61737
2021,"Medical scientists",157608,68740,88868,82928,85240,81619
2021,"Life scientists, all other",6906,4701,2205,66413,67466,54422
2021,"Astronomers and physicists",14329,11316,3013,133556,141015,117997
2021,"Atmospheric and space scientists",13297,8258,5039,94677,99379,85203
2021,"Chemists and materials scientists",89962,53970,35992,76334,77161,74666
2021,"Environmental scientists and specialists, including health",35959,19152,16807,66892,69707,65246
2021,"Geoscientists and hydrologists, except geographers",38580,29561,9019,98757,102975,77220
2021,"Physical scientists, all other",317067,180683,136384,90716,100282,81550
2021,"Economists",30063,19968,10095,132504,145824,119682
2021,"Survey researchers",1286,560,726,71563,71875,70703
2021,"Clinical and counseling psychologists",15523,5503,10020,99922,125126,90268
2021,"School psychologists",42939,8053,34886,77195,83817,76274
2021,"Other psychologists",97397,29591,67806,91924,108839,84310
2021,"Sociologists",1317,695,622,64438,92139,63532
2021,"Urban and regional planners",36973,20461,16512,80824,82926,78692
2021,"Miscellaneous social scientists and related workers",36340,20297,16043,88862,96161,80297
2021,"Agricultural and food science technicians",37464,24554,12910,50519,55521,42201
2021,"Biological technicians",27324,12851,14473,54096,52756,55486
2021,"Chemical technicians",51542,34745,16797,57420,59564,55511
2021,"Environmental science and geoscience technicians",16922,11329,5593,68082,72591,60533
2021,"Nuclear technicians",3250,2531,719,80239,81323,73786
2021,"Social science research assistants",8491,3761,4730,57975,63352,56896
2021,"Other life, physical, and social science technicians",160372,76172,84200,48994,50540,46946
2021,"Occupational health and safety specialists and technicians",79263,55275,23988,70045,73792,61184
2021,"Education, Legal, Community Service, Arts, and Media Occupations:",11786704,4282233,7504471,58230,67526,54006
2021,"Community and Social Service Occupations:",2084760,729566,1355194,51603,52184,51294
2021,"Substance abuse and behavioral disorder counselors",95929,24258,71671,47299,46817,47469
2021,"Educational, guidance, and career counselors and advisors",285492,63484,222008,55934,55991,55920
2021,"Marriage and family therapists",20910,4859,16051,60567,67697,59188
2021,"Mental health counselors",112815,25885,86930,51903,55066,51586
2021,"Rehabilitation counselors",17129,5545,11584,53167,51042,55025
2021,"Counselors, all other",120139,40717,79422,46785,47610,46452
2021,"Child, family, and school social workers",58169,8380,49789,50716,46405,51446
2021,"Healthcare social workers",71844,15434,56410,54898,50651,55907
2021,"Mental health and substance abuse social workers",25257,4640,20617,60615,55977,60862
2021,"Social workers, all other",490280,88808,401472,52546,53489,52440
2021,"Probation officers and correctional treatment specialists",87639,41244,46395,57581,62091,54052
2021,"Social and human service assistants",173287,38894,134393,42112,47544,41263
2021,"Other community and social service specialists",76831,22214,54617,50950,50979,50942
2021,"Clergy",363555,305862,57693,51642,52058,48273
2021,"Directors, religious activities and education",45155,21533,23622,47684,49146,47411
2021,"Religious workers, all other",40329,17809,22520,42355,49637,39756
2021,"Legal Occupations:",1576225,747799,828426,102557,143425,77844
2021,"Lawyers",1014893,622110,392783,144628,155961,124812
2021,"Judicial law clerks",18450,5636,12814,54801,69167,51211
2021,"Judges, magistrates, and other judicial workers",64698,32481,32217,111762,144000,81142
2021,"Paralegals and legal assistants",353792,50878,302914,55084,54958,55099
2021,"Title examiners, abstractors, and searchers",78409,22143,56266,54475,89122,50594
2021,"Legal support workers, all other",45983,14551,31432,58994,70012,52995
2021,"Educational Instruction, and Library Occupations:",6261803,1809702,4452101,55329,63859,51984
2021,"Postsecondary teachers",954993,502156,452837,78272,84412,72002
2021,"Preschool and kindergarten teachers",476797,11561,465236,34569,36834,34426
2021,"Elementary and middle school teachers",2201887,449923,1751964,56218,60438,55272
2021,"Secondary school teachers",980600,425341,555259,61536,63889,59922
2021,"Special education teachers",327535,53285,274250,56235,55625,56351
2021,"Tutors",23964,8447,15517,36338,41930,35038
2021,"Other teachers and instructors",382328,171477,210851,51290,57514,47318
2021,"Archivists, curators, and museum technicians",54244,22677,31567,61540,64666,59986
2021,"Librarians and media collections specialists",141808,33366,108442,58138,64798,56909
2021,"Library technicians",14593,4247,10346,32051,35165,31725
2021,"Teaching assistants",597271,102031,495240,26522,32426,25575
2021,"Other educational instruction and library workers",105783,25191,80592,61041,67770,59054
2021,"Arts, Design, Entertainment, Sports, and Media Occupations:",1863916,995166,868750,62095,65256,59452
2021,"Artists and related workers",152375,90437,61938,52349,60497,45156
2021,"Commercial and industrial designers",11231,7640,3591,77086,82603,72982
2021,"Fashion designers",15066,2980,12086,51871,52431,51681
2021,"Floral designers",24475,3414,21061,34257,40772,33438
2021,"Graphic designers",204270,100261,104009,54421,56806,52414
2021,"Interior designers",67896,10253,57643,60641,60922,60615
2021,"Merchandise displayers and window trimmers",19571,7907,11664,37923,39926,37099
2021,"Other designers",262477,158766,103711,74660,78380,68766
2021,"Actors",10543,4804,5739,53170,80425,45495
2021,"Producers and directors",149680,93078,56602,75500,75945,74686
2021,"Athletes and sports competitors",19648,17339,2309,54335,54905,53320
2021,"Coaches and scouts",101517,65770,35747,51607,52556,50083
2021,"Umpires, referees, and other sports officials",2075,1414,661,57179,51250,90887
2021,"Dancers and choreographers",5063,1378,3685,27063,42238,23037
2021,"Music directors and composers",19770,14678,5092,59333,60903,57648
2021,"Musicians and singers",35698,28785,6913,45050,50795,33369
2021,"Disc jockeys, except radio",4144,4069,75,45565,44355,70987
2021,"Entertainers and performers, sports and related workers, all other",10403,6444,3959,35936,47446,28832
2021,"Broadcast announcers and radio disc jockeys",13469,9431,4038,56105,56525,52471
2021,"News analysts, reporters, and journalists",62182,33442,28740,61123,63892,56114
2021,"Public relations specialists",118889,39796,79093,76353,84212,72353
2021,"Editors",97329,44770,52559,66889,71229,62911
2021,"Technical writers",55363,23286,32077,79905,84320,75868
2021,"Writers and authors",125685,57565,68120,67797,74421,62373
2021,"Interpreters and translators",44723,14118,30605,46026,52652,41575
2021,"Court reporters and simultaneous captioners",19106,2498,16608,60919,49777,61408
2021,"Media and communication workers, all other",20123,8522,11601,70128,68162,70725
2021,"Broadcast, sound, and lighting technicians",62314,55357,6957,63820,65550,54701
2021,"Photographers",75569,44797,30772,46376,50184,41076
2021,"Television, video, and film camera operators and editors",52137,41088,11049,61173,61517,60047
2021,"Healthcare Practitioners and Technical Occupations:",7246380,2009340,5237040,72368,91134,68247
2021,"Chiropractors",41113,31934,9179,87707,93279,73446
2021,"Dentists",102331,71471,30860,162637,186372,136398
2021,"Dietitians and nutritionists",76924,6836,70088,59469,54658,59725
2021,"Optometrists",31637,16639,14998,122908,135015,105105
2021,"Pharmacists",261009,110132,150877,127646,131893,125627
2021,"Physician assistants",122904,44128,78776,113886,122304,110004
2021,"Podiatrists",9475,7269,2206,150993,154549,111117
2021,"Audiologists",12264,2050,10214,89026,90984,88814
2021,"Occupational therapists",88219,14401,73818,75897,81355,74543
2021,"Physical therapists",201897,84361,117536,84502,90491,82007
2021,"Radiation therapists",12973,4180,8793,88537,95841,78176
2021,"Recreational therapists",12423,2814,9609,50746,51889,50183
2021,"Respiratory therapists",99863,39434,60429,63319,66799,62143
2021,"Speech-language pathologists",120492,6496,113996,70955,85148,70234
2021,"Exercise physiologists",3634,1152,2482,49795,52898,49326
2021,"Therapists, all other",134367,28216,106151,55983,57341,55470
2021,"Veterinarians",72068,27124,44944,109533,126040,104226
2021,"Registered nurses",2535581,334253,2201328,74126,80003,73201
2021,"Nurse anesthetists",35981,16990,18991,185908,190138,181130
2021,"Nurse practitioners",211195,28482,182713,113026,124797,111213
2021,"Acupuncturists",7596,2174,5422,66134,49925,69915
2021,"Healthcare diagnosing or treating practitioners, all other",6271,2541,3730,55377,52938,56372
2021,"Clinical laboratory technologists and technicians",243360,71619,171741,52186,55584,51294
2021,"Dental hygienists",73864,5891,67973,62489,87250,61663
2021,"Cardiovascular technologists and technicians",44855,19755,25100,62640,81853,55277
2021,"Diagnostic medical sonographers",78196,19106,59090,75551,103743,71710
2021,"Radiologic technologists and technicians",179058,65977,113081,62648,71498,58202
2021,"Magnetic resonance imaging technologists",39696,17999,21697,80121,98906,72636
2021,"Nuclear medicine technologists and medical dosimetrists",26943,14393,12550,104521,131394,93870
2021,"Emergency medical technicians",88636,58123,30513,40630,41851,36990
2021,"Paramedics",87467,64508,22959,63302,65407,56062
2021,"Pharmacy technicians",256901,58721,198180,36810,38925,36395
2021,"Psychiatric technicians",61750,19604,42146,36469,37026,36154
2021,"Surgical technologists",90035,24371,65664,50266,61608,46440
2021,"Veterinary technologists and technicians",117122,16104,101018,35013,37285,34641
2021,"Dietetic technicians and ophthalmic medical technicians",30248,7632,22616,31061,31153,31025
2021,"Licensed practical and licensed vocational nurses",423489,52778,370711,46591,50618,46246
2021,"Medical records specialists",167694,16243,151451,45177,47499,44958
2021,"Opticians, dispensing",49403,16088,33315,40724,51079,37275
2021,"Miscellaneous health technologists and technicians",113049,43824,69225,47713,58071,41564
2021,"Other healthcare practitioners and technical occupations",75079,28166,46913,60913,66236,57739
2021,"Healthcare Support Occupations:",2964496,476203,2488293,32415,35982,32091
2021,"Home health aides",261045,37340,223705,31199,31228,31192
2021,"Personal care aides",777894,153348,624546,30383,32071,30010
2021,"Nursing assistants",825238,98054,727184,31758,35718,31457
2021,"Orderlies and psychiatric aides",43713,25610,18103,32579,32585,32573
2021,"Occupational therapy assistants and aides",28024,6049,21975,46600,50024,45778
2021,"Physical therapist assistants and aides",64571,21960,42611,50031,51254,47870
2021,"Massage therapists",44639,9449,35190,35944,42708,34995
2021,"Dental assistants",166272,12158,154114,35349,40485,35092
2021,"Medical assistants",434436,37180,397256,35170,40400,34721
2021,"Medical transcriptionists",21218,4054,17164,32989,31865,33214
2021,"Pharmacy aides",24176,5393,18783,36216,37269,35427
2021,"Veterinary assistants and laboratory animal caretakers",45388,7368,38020,30799,37865,29982
2021,"Phlebotomists",89281,14720,74561,35139,36764,34895
2021,"Other healthcare support workers",138601,43520,95081,36665,40120,35720
2021,"Protective Service Occupations:",2657117,2103808,553309,60193,63543,46812
2021,"First-line supervisors of correctional officers",38037,27246,10791,67027,69594,61189
2021,"First-line supervisors of police and detectives",90658,75158,15500,89663,95171,71806
2021,"First-line supervisors of firefighting and prevention workers",45869,44566,1303,100104,99557,114189
2021,"First-line supervisors of security workers",67654,48578,19076,59665,61497,51807
2021,"First-line supervisors of protective service workers, all other",3374,2511,863,59926,61125,46241
2021,"Firefighters",306801,292409,14392,73806,74554,54463
2021,"Fire inspectors",22483,20398,2085,68509,67895,71158
2021,"Bailiffs",25704,16989,8715,58931,66055,44606
2021,"Correctional officers and jailers",327350,237195,90155,52248,56480,45026
2021,"Detectives and criminal investigators",130932,96977,33955,83596,91050,66450
2021,"Fish and game wardens",5291,4761,530,61979,61908,68100
2021,"Parking enforcement workers",7641,5650,1991,44115,47224,41396
2021,"Police officers",784029,669554,114475,72173,74280,60876
2021,"Animal control workers",7896,3906,3990,39742,41419,37345
2021,"Private detectives and investigators",89044,44556,44488,60876,71473,52880
2021,"Security guards and gambling surveillance officers",616334,460471,155863,36558,37097,34713
2021,"Crossing guards and flaggers",14560,8927,5633,35823,33541,40059
2021,"Transportation security screeners",35450,23246,12204,46291,47374,44589
2021,"School bus monitors",9389,1549,7840,30391,32147,28005
2021,"Other protective service workers",28621,19161,9460,37740,38919,35776
2021,"Food Preparation and Serving Related Occupations:",2787670,1401629,1386041,26981,29956,25231
2021,"Chefs and head cooks",285785,223746,62039,37489,40453,30651
2021,"First-line supervisors of food preparation and serving workers",299162,123760,175402,31007,34569,28844
2021,"Cooks",936526,551088,385438,25964,27146,24030
2021,"Food preparation workers",296630,130544,166086,25937,27451,24441
2021,"Bartenders",129820,60442,69378,32052,35039,30846
2021,"Fast food and counter workers",177298,66255,111043,23260,23007,23398
2021,"Waiters and waitresses",433220,140264,292956,25806,29016,24553
2021,"Food servers, nonrestaurant",71537,22111,49426,26439,28945,25626
2021,"Dining room and cafeteria attendants and bartender helpers",50134,22993,27141,25235,30396,21581
2021,"Dishwashers",67658,51334,16324,23554,24085,22378
2021,"Hosts and hostesses, restaurant, lounge, and coffee shop",35297,7571,27726,21770,28710,20628
2021,"Food preparation and serving related workers, all other",4603,1521,3082,22688,23094,22517
2021,"Building and Grounds Cleaning and Maintenance Occupations:",3093287,2092550,1000737,31615,35078,26624
2021,"First-line supervisors of housekeeping and janitorial workers",167854,106802,61052,42248,49431,33670
2021,"First-line supervisors of landscaping, lawn service, and groundskeeping workers",116011,109466,6545,46217,46982,38933
2021,"Janitors and building cleaners",1399454,981038,418416,32124,35467,26923
2021,"Maids and housekeeping cleaners",568181,96535,471646,26117,30116,25513
2021,"Pest control workers",74021,69728,4293,41626,42085,31838
2021,"Landscaping and groundskeeping workers",691036,655826,35210,30890,30973,29237
2021,"Tree trimmers and pruners",67644,64933,2711,41388,41382,43169
2021,"Other grounds maintenance workers",9086,8222,864,36724,36913,31880
2021,"Personal Care and Service Occupations:",1508741,416563,1092178,31094,37026,29446
2021,"Supervisors of personal care and service workers",35674,16595,19079,45291,51805,40556
2021,"Animal trainers",31676,13254,18422,37058,40392,36008
2021,"Animal caretakers",128378,36597,91781,31085,36413,30319
2021,"Gambling services workers",51512,26835,24677,41034,45417,37387
2021,"Ushers, lobby attendants, and ticket takers",3733,2016,1717,35388,35934,31575
2021,"Other entertainment attendants and related workers",49044,28637,20407,29933,30548,27661
2021,"Embalmers, crematory operators and funeral attendants",10335,6768,3567,39518,39867,32098
2021,"Morticians, undertakers, and funeral arrangers",35497,24856,10641,54051,58389,49330
2021,"Barbers",55954,45115,10839,30165,29509,31907
2021,"Hairdressers, hairstylists, and cosmetologists",286507,30220,256287,31311,37587,30978
2021,"Manicurists and pedicurists",123761,26951,96810,25656,28906,25223
2021,"Skincare specialists",31338,531,30807,32805,4375,33905
2021,"Other personal appearance workers",8127,526,7601,26868,19816,27153
2021,"Baggage porters, bellhops, and concierges",44080,32743,11337,36748,40623,31944
2021,"Tour and travel guides",15882,11348,4534,31442,32005,30941
2021,"Childcare workers",380451,22323,358128,25365,26729,25241
2021,"Exercise trainers and group fitness instructors",68784,37229,31555,37083,40525,34850
2021,"Recreation workers",79340,27914,51426,37256,42330,35835
2021,"Residential advisors",23022,7317,15705,33414,34878,32701
2021,"Personal care and service workers, all other",45646,18788,26858,32424,32158,32911
2021,"Sales and Related Occupations:",8996896,5252747,3744149,51457,61244,41002
2021,"First-Line supervisors of retail sales workers",2298849,1320424,978425,48395,53929,41124
2021,"First-Line supervisors of non-retail sales workers",897166,610963,286203,72046,73379,69760
2021,"Cashiers",893146,269010,624136,25389,26830,24732
2021,"Counter and rental clerks",40496,26857,13639,42595,46174,33505
2021,"Parts salespersons",94297,84895,9402,42354,43555,34860
2021,"Retail salespersons",1461348,895753,565595,39546,46019,31679
2021,"Advertising sales agents",86861,45286,41575,67398,68208,66313
2021,"Insurance sales agents",479593,235851,243742,56965,73433,48991
2021,"Securities, commodities, and financial services sales agents",190335,138141,52194,103914,122331,81624
2021,"Travel agents",24293,4592,19701,40650,41642,39970
2021,"Sales representatives of services, except advertising, insurance, financial services, and travel",505285,361992,143293,77885,83829,66410
2021,"Sales representatives, wholesale and manufacturing",1016867,742353,274514,74535,78238,63054
2021,"Models, demonstrators, and product promoters",10339,4634,5705,36760,39777,33661
2021,"Real estate brokers and sales agents",596244,282094,314150,71190,81594,62587
2021,"Sales engineers",49131,45512,3619,122715,123271,114306
2021,"Telemarketers",17193,5619,11574,30956,31373,30846
2021,"Door-to-door sales workers, news and street vendors, and related workers",31726,18618,13108,36034,40308,31063
2021,"Sales and related workers, all other",303727,160153,143574,51533,65400,40968
2021,"Office and Administrative Support Occupations:",11749720,3180392,8569328,41853,47069,40842
2021,"First-Line supervisors of office and administrative support workers",946726,304098,642628,53772,64164,50957
2021,"Switchboard operators, including answering service",10354,2791,7563,33142,37474,31574
2021,"Telephone operators",15721,3742,11979,34482,36658,33985
2021,"Communications equipment operators, all other",3957,1516,2441,52359,58549,50620
2021,"Bill and account collectors",102016,26739,75277,41486,45966,40588
2021,"Billing and posting clerks",361880,42995,318885,40054,45938,39504
2021,"Bookkeeping, accounting, and auditing clerks",795654,118019,677635,44495,46288,44175
2021,"Gambling cage workers",8818,1843,6975,35100,50925,32404
2021,"Payroll and timekeeping clerks",131485,18986,112499,48994,46134,49507
2021,"Procurement clerks",38885,17108,21777,58258,66836,50907
2021,"Tellers",166643,23011,143632,32184,32236,32173
2021,"Financial clerks, all other",112437,44915,67522,59036,87882,49640
2021,"Brokerage clerks",6001,1003,4998,51225,72229,49306
2021,"Correspondence clerks",4966,1562,3404,51160,46261,54056
2021,"Court, municipal, and license clerks",70242,13809,56433,45099,47084,43756
2021,"Credit authorizers, checkers, and clerks",35892,7659,28233,49556,61414,46953
2021,"Customer service representatives",1917725,638839,1278886,39116,42343,37274
2021,"Eligibility interviewers, government programs",76665,18600,58065,46233,50696,44507
2021,"File clerks",95456,21455,74001,39898,42149,38865
2021,"Hotel, motel, and resort desk clerks",56704,18286,38418,25444,27106,24992
2021,"Interviewers, except eligibility and loan",111410,23195,88215,36879,39961,36429
2021,"Library assistants, clerical",35573,8358,27215,33300,34905,32900
2021,"Loan interviewers and clerks",135970,30927,105043,49839,52409,47297
2021,"New accounts clerks",11400,2116,9284,40334,46000,39434
2021,"Order clerks",57787,26958,30829,39311,40665,38364
2021,"Human resources assistants, except payroll and timekeeping",54792,11408,43384,50316,61114,46472
2021,"Receptionists and information clerks",723332,75075,648257,32397,39724,32109
2021,"Reservation and transportation ticket agents and travel clerks",68619,36310,32309,44793,47268,40954
2021,"Information and record clerks, all other",71189,16324,54865,41975,49902,40965
2021,"Cargo and freight agents",18867,11736,7131,46424,52108,42840
2021,"Couriers and messengers",305183,250966,54217,38505,40384,30975
2021,"Public safety telecommunicators",89946,27486,62460,45535,48224,43746
2021,"Dispatchers, except police, fire, and ambulance",141622,68448,73174,42257,51474,38628
2021,"Meter readers, utilities",18219,16253,1966,45564,45770,44848
2021,"Postal service clerks",102617,47172,55445,56171,61706,51249
2021,"Postal service mail carriers",294088,185765,108323,59603,61092,55941
2021,"Postal service mail sorters, processors, and processing machine operators",47529,23007,24522,52055,56416,47716
2021,"Production, planning, and expediting clerks",220367,111942,108425,57161,64958,50124
2021,"Shipping, receiving, and inventory clerks",456166,301877,154289,36835,38314,34822
2021,"Weighers, measurers, checkers, and samplers, recordkeeping",49997,27212,22785,39229,44502,36110
2021,"Executive secretaries and executive administrative assistants",233339,13167,220172,63646,59589,63982
2021,"Legal secretaries and administrative assistants",46669,1900,44769,53487,59135,52933
2021,"Medical secretaries and administrative assistants",67982,6014,61968,39237,45610,38975
2021,"Secretaries and administrative assistants, except legal, medical, and executive",1541391,110655,1430736,41767,49636,41478
2021,"Data entry keyers",191759,42530,149229,37238,38441,37074
2021,"Word processors and typists",21768,3559,18209,40683,44606,40286
2021,"Desktop publishers",1479,644,835,52421,61385,50299
2021,"Insurance claims and policy processing clerks",195615,36270,159345,41795,42562,41528
2021,"Mail clerks and mail machine operators, except postal service",45381,24648,20733,34608,36139,32940
2021,"Office clerks, general",772410,141925,630485,38574,43961,37368
2021,"Office machine operators, except computer",26073,11563,14510,33780,35857,32311
2021,"Proofreaders and copy markers",6018,994,5024,43281,69583,42016
2021,"Statistical assistants",25574,12401,13173,57098,65009,52420
2021,"Office and administrative support workers, all other",601362,144611,456751,46581,51543,44989
2021,"Natural Resources, Construction, and Maintenance Occupations:",10065492,9645514,419978,49104,50056,36158
2021,"Farming, Fishing, and Forestry Occupations:",579905,460859,119046,33304,35735,27443
2021,"First-line supervisors of farming, fishing, and forestry workers",37652,32400,5252,47391,50514,42693
2021,"Agricultural inspectors",9045,6527,2518,52933,55942,50044
2021,"Animal breeders",5790,3722,2068,36699,41168,27847
2021,"Graders and sorters, agricultural products",32652,13314,19338,29524,31456,27706
2021,"Miscellaneous agricultural workers",430172,345512,84660,31716,33071,26622
2021,"Fishing and hunting workers",17760,16466,1294,42586,47569,26330
2021,"Forest and conservation workers",14690,12119,2571,43284,46099,36859
2021,"Logging workers",32144,30799,1345,40033,40123,38915
2021,"Construction and Extraction Occupations:",5491759,5327382,164377,46910,47149,39846
2021,"First-line supervisors of construction trades and extraction workers",537525,518003,19522,63502,64032,47932
2021,"Boilermakers",11130,10413,717,61467,62429,35995
2021,"Brickmasons, blockmasons, and stonemasons",87360,86464,896,42838,43196,21892
2021,"Carpenters",774072,758376,15696,42914,43189,39953
2021,"Carpet, floor, and tile installers and finishers",80916,78582,2334,40321,40542,22109
2021,"Cement masons, concrete finishers, and terrazzo workers",40181,39939,242,45439,45369,109059
2021,"Construction laborers",1174004,1134738,39266,40054,40213,32054
2021,"Construction equipment operators",302532,296972,5560,51586,51685,32670
2021,"Drywall installers, ceiling tile installers, and tapers",95159,92842,2317,38973,39364,34665
2021,"Electricians",746973,732195,14778,56709,56969,48039
2021,"Glaziers",37025,36340,685,46533,46878,30419
2021,"Insulation workers",38194,37598,596,50958,51025,46189
2021,"Painters and paperhangers",333769,311599,22170,37248,37846,31077
2021,"Pipelayers",39094,38605,489,43830,43778,73848
2021,"Plumbers, pipefitters, and steamfitters",465305,456655,8650,51703,51668,58257
2021,"Roofers",139496,137715,1781,38911,39049,31141
2021,"Sheet metal workers",98759,94416,4343,49093,49755,42319
2021,"Structural iron and steel workers",45747,45270,477,55523,55630,46148
2021,"Helpers, construction trades",29299,27483,1816,33018,32385,43750
2021,"Construction and building inspectors",82535,73596,8939,63801,64396,61629
2021,"Elevator and escalator installers and repairers",27843,27343,500,92827,93271,59667
2021,"Fence erectors",23001,22071,930,35792,34617,70745
2021,"Hazardous materials removal workers",18523,13564,4959,45507,50660,33003
2021,"Highway maintenance workers",72739,70583,2156,44679,44847,41963
2021,"Rail-track laying and maintenance equipment operators",7663,7100,563,60070,53676,61497
2021,"Miscellaneous construction and related workers",24306,23663,643,42207,42161,45457
2021,"Earth drillers, except oil and gas",18283,17602,681,51650,52220,31615
2021,"Explosives workers, ordnance handling experts, and blasters",6008,5540,468,62678,64257,36859
2021,"Underground mining machine operators",34203,33124,1079,71708,71883,63807
2021,"Other extraction workers",37754,37401,353,56504,56551,45288
2021,"Installation, Maintenance, and Repair Occupations:",3993828,3857273,136555,52167,52346,43061
2021,"First-line supervisors of mechanics, installers, and repairers",217498,201943,15555,69147,70031,57057
2021,"Computer, automated teller, and office machine repairers",117808,105882,11926,50323,50696,43655
2021,"Radio and telecommunications equipment installers and repairers",128838,119055,9783,59459,60345,51664
2021,"Avionics technicians",13455,11756,1699,70016,73120,61492
2021,"Electric motor, power tool, and related repairers",20001,19354,647,52767,53737,36543
2021,"Electrical and electronics repairers, industrial and utility",12854,12163,691,78977,79881,47475
2021,"Audiovisual equipment installers and repairers",32980,30838,2142,49700,50118,46250
2021,"Security and fire alarm systems installers",48196,47214,982,51012,51237,34913
2021,"Aircraft mechanics and service technicians",138159,132416,5743,70247,70631,60315
2021,"Automotive body and related repairers",104072,102308,1764,45302,45663,36710
2021,"Automotive glass installers and repairers",14802,14314,488,44209,43640,70714
2021,"Automotive service technicians and mechanics",683170,672420,10750,44015,44353,34981
2021,"Bus and truck mechanics and diesel engine specialists",277491,274230,3261,52506,52563,46767
2021,"Heavy vehicle and mobile equipment service technicians and mechanics",190639,188672,1967,60747,60788,52235
2021,"Small engine mechanics",37575,37091,484,40203,40276,34235
2021,"Miscellaneous vehicle and mobile equipment mechanics, installers, and repairers",57401,56272,1129,35433,35355,36988
2021,"Control and valve installers and repairers",21784,21534,250,56777,56758,67708
2021,"Heating, air conditioning, and refrigeration mechanics and installers",352550,347256,5294,51613,51671,41299
2021,"Home appliance repairers",26073,24603,1470,42352,43313,32433
2021,"Industrial and refractory machinery mechanics",327811,319320,8491,60350,60638,49832
2021,"Maintenance and repair workers, general",630032,604649,25383,50643,50900,38324
2021,"Maintenance workers, machinery",18028,17515,513,53233,55083,51189
2021,"Millwrights",42096,41530,566,71101,71140,53904
2021,"Electrical power-line installers and repairers",113935,112512,1423,84811,85368,44414
2021,"Telecommunications line installers and repairers",100409,96216,4193,63341,64534,43306
2021,"Precision instrument and equipment repairers",46283,41876,4407,60463,61284,50935
2021,"Coin, vending, and amusement machine servicers and repairers",20243,18477,1766,40449,40683,32663
2021,"Locksmiths and safe repairers",21580,19830,1750,46260,47236,31127
2021,"Manufactured building and mobile home installers",3332,2923,409,41506,41658,37432
2021,"Riggers",7566,7358,208,55205,53421,55959
2021,"Helpers--installation, maintenance, and repair workers",11824,9394,2430,30274,30416,28333
2021,"Other installation, maintenance, and repair workers",140740,132172,8568,44159,44889,32460
2021,"Production Occupations:",6513044,4803799,1709245,42199,46794,34003
2021,"First-line supervisors of production and operating workers",680273,531749,148524,60873,64402,45515
2021,"Aircraft structure, surfaces, rigging, and systems assemblers",3539,2209,1330,50807,58821,31560
2021,"Electrical, electronics, and electromechanical assemblers",91847,48935,42912,36782,40675,33706
2021,"Engine and other machine assemblers",10388,8391,1997,48872,50351,46535
2021,"Structural metal fabricators and fitters",23218,21258,1960,51060,51507,30842
2021,"Other assemblers and fabricators",700586,443752,256834,36600,39217,32982
2021,"Bakers",121930,57906,64024,31459,33425,30431
2021,"Butchers and other meat, poultry, and fish processing workers",191575,154251,37324,36728,38622,31810
2021,"Food and tobacco roasting, baking, and drying machine operators and tenders",8166,7084,1082,43076,43911,31909
2021,"Food batchmakers",61565,29361,32204,35177,41840,31357
2021,"Food cooking machine operators and tenders",5824,3983,1841,30983,30352,31998
2021,"Food processing workers, all other",121205,78234,42971,40082,41780,34963
2021,"Computer numerically controlled tool operators and programmers",76122,69599,6523,49226,50195,39128
2021,"Forming machine setters, operators, and tenders, metal and plastic",26733,22578,4155,43929,44589,41204
2021,"Cutting, punching, and press machine setters, operators, and tenders, metal and plastic",57960,47457,10503,37841,39410,35605
2021,"Grinding, lapping, polishing, and buffing machine tool setters, operators, and tenders, metal and plastic",28691,24476,4215,40234,40965,34604
2021,"Other machine tool setters, operators, and tenders, metal and plastic",7849,6533,1316,46300,46456,42055
2021,"Machinists",302403,292173,10230,52074,52275,39034
2021,"Metal furnace operators, tenders, pourers, and casters",15225,13430,1795,51969,54647,35235
2021,"Model makers and patternmakers, metal and plastic",3661,2933,728,63106,73197,48860
2021,"Molders and molding machine setters, operators, and tenders, metal and plastic",26351,21587,4764,39906,42677,30761
2021,"Tool and die makers",46115,45153,962,61235,61419,30011
2021,"Welding, soldering, and brazing workers",463592,442090,21502,45893,46487,35104
2021,"Other metal workers and plastic workers",321529,256737,64792,41133,42702,35530
2021,"Prepress technicians and workers",14955,9938,5017,41370,46164,31618
2021,"Printing press operators",111644,86988,24656,41226,43017,34313
2021,"Print binding and finishing workers",10067,6153,3914,40806,49758,31649
2021,"Laundry and dry-cleaning workers",70997,23808,47189,27015,30776,26198
2021,"Pressers, textile, garment, and related materials",13747,8060,5687,33010,36425,26437
2021,"Sewing machine operators",83054,24344,58710,29839,31333,28134
2021,"Shoe and leather workers",6583,5123,1460,35837,40287,30083
2021,"Tailors, dressmakers, and sewers",27356,8830,18526,29096,32278,28165
2021,"Textile machine setters, operators, and tenders",15988,7379,8609,30060,28152,30388
2021,"Upholsterers",17071,13899,3172,36009,36846,33211
2021,"Other textile, apparel, and furnishings workers",11916,6740,5176,37204,41049,31024
2021,"Cabinetmakers and bench carpenters",36469,34972,1497,41543,41886,22403
2021,"Furniture finishers",7935,6311,1624,35764,37184,21704
2021,"Sawing machine setters, operators, and tenders, wood",21181,18496,2685,37552,38500,36236
2021,"Woodworking machine setters, operators, and tenders, except sawing",10773,8120,2653,37916,41407,28406
2021,"Other woodworkers",17591,15989,1602,39043,40028,29208
2021,"Power plant operators, distributors, and dispatchers",41209,39411,1798,102891,103344,65905
2021,"Stationary engineers and boiler operators",88042,84790,3252,69405,69654,63750
2021,"Water and wastewater treatment plant and system operators",91226,86094,5132,56446,56586,53269
2021,"Miscellaneous plant and system operators",35673,34170,1503,71178,71488,58189
2021,"Chemical processing machine setters, operators, and tenders",59730,52571,7159,57253,59408,38236
2021,"Crushing, grinding, polishing, mixing, and blending workers",65192,58375,6817,42736,44618,31880
2021,"Cutting workers",40478,30513,9965,36999,39235,31340
2021,"Extruding, forming, pressing, and compacting machine setters, operators, and tenders",19817,15383,4434,39526,40742,32200
2021,"Furnace, kiln, oven, drier, and kettle operators and tenders",8079,6879,1200,45607,50587,35596
2021,"Inspectors, testers, sorters, samplers, and weighers",660266,417208,243058,47045,53066,37466
2021,"Jewelers and precious stone and metal workers",26900,16139,10761,46700,49903,41093
2021,"Dental and ophthalmic laboratory technicians and medical appliance technicians",55519,24964,30555,39249,51611,35406
2021,"Packaging and filling machine operators and tenders",194284,88902,105382,33493,38073,31220
2021,"Painting workers",114288,104235,10053,42027,42313,35279
2021,"Photographic process workers and processing machine operators",24554,17437,7117,71559,75319,50975
2021,"Adhesive bonding machine operators and tenders",7917,4722,3195,42228,48941,40471
2021,"Etchers and engravers",6385,3917,2468,42035,42083,41996
2021,"Molders, shapers, and casters, except metal and plastic",20650,18385,2265,39649,40024,30033
2021,"Paper goods machine setters, operators, and tenders",15052,10466,4586,49453,54187,31916
2021,"Tire builders",12500,11479,1021,46571,47861,43099
2021,"Helpers--production workers",36383,25747,10636,30824,31344,27475
2021,"Other production equipment operators and tenders",6991,5983,1008,35810,36674,31623
2021,"Other production workers",1008235,729020,279215,39973,42355,32570
2021,"Transportation and Material Moving Occupations:",7717755,6336490,1381265,40104,41748,31204
2021,"Transportation Occupations:",3924770,3496398,428372,50033,50848,36219
2021,"Supervisors of transportation and material moving workers",250906,186548,64358,52083,54946,42133
2021,"Aircraft pilots and flight engineers",105157,98806,6351,124279,126654,66683
2021,"Air traffic controllers and airfield operations specialists",34500,27458,7042,101900,103215,84347
2021,"Flight attendants",44824,12491,32333,52462,57217,51670
2021,"Ambulance drivers and attendants, except emergency medical technicians",6587,4889,1698,30437,30790,24877
2021,"Bus drivers, school",91110,40985,50125,31488,35281,29823
2021,"Bus drivers, transit and intercity",136931,93430,43501,47359,51316,40072
2021,"Driver/sales workers and truck drivers",2688943,2544011,144932,50237,50665,32433
2021,"Shuttle drivers and chauffeurs",31207,25742,5465,35089,36442,27868
2021,"Taxi drivers",165505,144580,20925,35732,36445,28349
2021,"Motor vehicle operators, all other",67612,55819,11793,35995,37831,30188
2021,"Locomotive engineers and operators",32394,30388,2006,91619,94520,56677
2021,"Railroad conductors and yardmasters",36130,33279,2851,77227,77636,76197
2021,"Other rail transportation workers",18013,15338,2675,72996,74410,71520
2021,"Sailors and marine oilers",18365,17746,619,51397,52056,36382
2021,"Ship and boat captains and operators",27748,25820,1928,75963,78163,39260
2021,"Ship engineers",3754,3533,221,88317,89665,41653
2021,"Parking attendants",26867,24251,2616,28328,28696,26605
2021,"Transportation service attendants",59009,51706,7303,30602,30968,24959
2021,"Transportation inspectors",32020,28666,3354,65957,68108,52332
2021,"Passenger attendants",11699,4108,7591,29144,45298,25131
2021,"Other transportation workers",35489,26804,8685,52313,54458,50943
2021,"Material Moving Occupations:",3792985,2840092,952893,33419,35459,30257
2021,"Crane and tower operators",53006,52071,935,64828,65103,50198
2021,"Conveyor, dredge, and hoist and winch operators",16360,15170,1190,48253,50442,34610
2021,"Industrial truck and tractor operators",505418,462162,43256,37327,37393,36405
2021,"Cleaners of vehicles and equipment",209680,174539,35141,31241,31574,29889
2021,"Laborers and freight, stock, and material movers, hand",1545200,1220901,324299,34780,36255,30367
2021,"Machine feeders and offbearers",18236,10082,8154,31876,34717,29545
2021,"Packers and packagers, hand",331821,150887,180934,29811,30880,28094
2021,"Stockers and order fillers",969194,628961,340233,31164,31648,30264
2021,"Pumping station operators",20505,19594,911,69626,68565,93402
2021,"Refuse and recyclable material collectors",70075,61562,8513,38942,40614,29156
2021,"Other material moving workers",53490,44163,9327,40736,43102,32754
2022,"Chief executives",1426995,1019568,407427,159808,174891,136126
2022,"General and operations managers",1176602,776480,400122,81426,88195,71358
2022,"Legislators",13390,8069,5321,72234,75576,64237
2022,"Advertising and promotions managers",51832,22945,28887,86211,108860,78248
2022,"Marketing managers",550021,213970,336051,93501,105433,85327
2022,"Sales managers",538413,372095,166318,108275,121666,86475
2022,"Public relations and fundraising managers",102024,33508,68516,85602,97298,80813
2022,"Administrative services managers",55365,15535,39830,69447,86262,64527
2022,"Facilities managers",112151,89784,22367,75700,79014,63293
2022,"Computer and information systems managers",608886,443785,165101,127142,131824,113908
2022,"Financial managers",1369774,619758,750016,92533,115793,77072
2022,"Compensation and benefits managers",19666,4057,15609,107377,140212,104067
2022,"Human resources managers",272528,67363,205165,96232,109596,92335
2022,"Training and development managers",72114,29597,42517,85456,91723,78068
2022,"Industrial production managers",289682,221926,67756,90009,91286,81724
2022,"Purchasing managers",234722,117357,117365,87491,95969,81442
2022,"Transportation, storage, and distribution managers",304688,239844,64844,64609,65314,61821
2022,"Farmers, ranchers, and other agricultural managers",463298,402198,61100,50519,51890,37170
2022,"Construction managers",944485,864745,79740,83790,84670,75350
2022,"Education and childcare administrators",894262,318091,576171,79682,91309,73150
2022,"Architectural and engineering managers",214519,189262,25257,158325,159400,151802
2022,"Food service managers",783422,422635,360787,48167,53816,41433
2022,"Funeral home managers",7195,3643,3552,74296,95277,60988
2022,"Entertainment and recreation managers",47730,30321,17409,57888,61369,53676
2022,"Lodging managers",99384,52915,46469,58185,65160,52213
2022,"Medical and health services managers",731398,204296,527102,81740,91963,78812
2022,"Natural sciences managers",42001,15085,26916,82685,89828,77602
2022,"Postmasters and mail superintendents",23657,12411,11246,82241,86108,78405
2022,"Property, real estate, and community association managers",471991,220884,251107,63550,73388,57521
2022,"Social and community service managers",456846,134049,322797,64254,72390,62101
2022,"Emergency management directors",14342,9100,5242,86406,93258,75270
2022,"Personal service managers, all other",59103,19295,39808,49420,62724,45091
2022,"Managers, all other",3971697,2455515,1516182,93144,102003,80164
2022,"Business and Financial Operations Occupations:",8274826,3873340,4401486,79502,90069,71856
2022,"Agents and business managers of artists, performers, and athletes",38529,21211,17318,80544,86989,77522
2022,"Buyers and purchasing agents, farm products",11016,7827,3189,60016,57154,60689
2022,"Wholesale and retail buyers, except farm products",162959,83545,79414,49096,49268,48925
2022,"Purchasing agents, except wholesale, retail, and farm products",258874,122580,136294,64287,66926,61882
2022,"Claims adjusters, appraisers, examiners, and investigators",310640,123246,187394,62505,71947,56033
2022,"Compliance officers",318026,142392,175634,76409,78206,75146
2022,"Cost estimators",144707,121540,23167,77484,81208,62419
2022,"Human resources workers",891153,227697,663456,69090,76169,67046
2022,"Compensation, benefits, and job analysis specialists",75148,20335,54813,65693,72058,62674
2022,"Training and development specialists",163797,76066,87731,69172,74779,64361
2022,"Logisticians",163635,102377,61258,61013,63544,57006
2022,"Project management specialists",881434,484191,397243,95459,101467,88226
2022,"Management analysts",843716,478995,364721,100415,106052,90607
2022,"Meeting, convention, and event planners",108107,26274,81833,60362,61757,60240
2022,"Fundraisers",69452,18839,50613,80245,91118,77105
2022,"Market research analysts and marketing specialists",359922,151099,208823,78777,87080,73866
2022,"Business operations specialists, all other",398142,174164,223978,71055,83974,62437
2022,"Accountants and auditors",1477357,620203,857154,80484,91014,74083
2022,"Property appraisers and assessors",71885,47403,24482,74566,80357,62466
2022,"Budget analysts",46344,16899,29445,86190,94450,82126
2022,"Credit analysts",32625,16399,16226,67216,71535,64683
2022,"Financial and investment analysts",315205,183483,131722,94528,102368,86475
2022,"Personal financial advisors",413396,287413,125983,112886,131967,83251
2022,"Insurance underwriters",128162,51085,77077,74709,81183,71420
2022,"Financial examiners",21466,11521,9945,82323,96265,63210
2022,"Credit counselors and loan officers",350286,166771,183515,74696,94848,62044
2022,"Tax examiners and collectors, and revenue agents",60965,22196,38769,58679,76447,56072
2022,"Tax preparers",65064,26768,38296,64212,77442,58976
2022,"Other financial specialists",92814,40821,51993,79522,104766,67224
2022,"Computer, Engineering, and Science Occupations:",10169079,7585606,2583473,94945,99692,83152
2022,"Computer and Mathematical Occupations:",5417891,4045406,1372485,100196,103298,87509
2022,"Computer and information research scientists",28545,21461,7084,112742,106155,123310
2022,"Computer systems analysts",535886,320955,214931,87856,92580,82464
2022,"Information security analysts",175555,146013,29542,113090,115110,106640
2022,"Computer programmers",250047,205941,44106,102971,104611,95305
2022,"Software developers",1846122,1512175,333947,126647,129101,115495
2022,"Software quality assurance analysts and testers",75997,39994,36003,86813,90429,82827
2022,"Web developers",78568,57718,20850,81429,83108,76955
2022,"Web and digital interface designers",48594,26241,22353,78898,82317,74038
2022,"Computer support specialists",589758,444692,145066,65931,66881,63051
2022,"Database administrators and architects",125962,89681,36281,105553,114609,78027
2022,"Network and computer systems administrators",218521,181907,36614,84262,85235,78060
2022,"Computer network architects",112961,101784,11177,105262,105770,101285
2022,"Computer occupations, all other",733042,563854,169188,76909,78411,72532
2022,"Actuaries",39517,27474,12043,130185,132140,122497
2022,"Mathematicians",3016,2268,748,118519,117257,119472
2022,"Operations research analysts",178336,89616,88720,90440,96474,84185
2022,"Statisticians",46252,23731,22521,96339,97275,92952
2022,"Other mathematical science occupations",331212,189901,141311,91190,100182,81337
2022,"Architecture and Engineering Occupations:",3249897,2733381,516516,95144,96938,85163
2022,"Architects, except landscape and naval",202070,150719,51351,103384,110070,86431
2022,"Landscape architects",24750,17807,6943,80363,85003,68008
2022,"Surveyors, cartographers, and photogrammetrists",28511,23445,5066,74594,75969,69524
2022,"Aerospace engineers",155010,133666,21344,116639,118953,106551
2022,"Bioengineers and biomedical engineers",15553,12542,3011,95351,94521,103865
2022,"Chemical engineers",82100,66064,16036,113564,114076,112291
2022,"Civil engineers",429376,358874,70502,99857,101084,92430
2022,"Computer hardware engineers",55125,47982,7143,119711,120913,107098
2022,"Electrical and electronics engineers",253092,232283,20809,111528,112930,103023
2022,"Environmental engineers",30035,20496,9539,97181,102469,87249
2022,"Industrial engineers, including health and safety",270858,206902,63956,92528,94349,86967
2022,"Marine engineers and naval architects",12940,12073,867,103113,104597,82378
2022,"Materials engineers",44999,38118,6881,95351,95850,91945
2022,"Mechanical engineers",327657,297171,30486,97838,98686,93962
2022,"Mining and geological engineers, including mining safety engineers",4728,4339,389,108090,108479,96420
2022,"Nuclear engineers",6408,5955,453,105055,109317,86993
2022,"Petroleum engineers",18862,17042,1820,160807,161474,153838
2022,"Engineers, all other",596232,512871,83361,107364,108357,103741
2022,"Architectural and civil drafters",43627,36080,7547,64223,64941,61212
2022,"Other drafters",77558,63873,13685,62913,63541,56194
2022,"Electrical and electronic engineering technologists and technicians",93709,84379,9330,69010,71105,49612
2022,"Other engineering technologists and technicians, except drafters",412315,331462,80853,63817,66660,52072
2022,"Surveying and mapping technicians",60327,55215,5112,55964,56945,46909
2022,"Life, Physical, and Social Science Occupations:",1501291,806819,694472,78172,82726,73766
2022,"Agricultural and food scientists",32717,22313,10404,81318,86371,74307
2022,"Biological scientists",84269,44954,39315,74822,78593,71622
2022,"Conservation scientists and foresters",26456,17493,8963,65619,70267,59710
2022,"Medical scientists",141106,60923,80183,83891,88366,81833
2022,"Life scientists, all other",7026,2838,4188,76793,79274,73406
2022,"Astronomers and physicists",16327,13613,2714,116101,128655,102606
2022,"Atmospheric and space scientists",12266,10446,1820,89092,90551,83784
2022,"Chemists and materials scientists",96014,59299,36715,82181,91206,70382
2022,"Environmental scientists and specialists, including health",39059,22962,16097,75530,76256,73856
2022,"Geoscientists and hydrologists, except geographers",39288,31081,8207,92283,92221,92644
2022,"Physical scientists, all other",334095,189597,144498,92068,101138,82357
2022,"Economists",31323,19004,12319,128589,143243,119646
2022,"Survey researchers",1520,485,1035,74009,106362,61570
2022,"Clinical and counseling psychologists",14269,4883,9386,115071,124647,104725
2022,"School psychologists",40631,5377,35254,80752,82558,80587
2022,"Other psychologists",109751,31752,77999,96483,106467,89723
2022,"Sociologists",3113,695,2418,86715,86983,86460
2022,"Urban and regional planners",36742,20347,16395,83800,89119,75641
2022,"Miscellaneous social scientists and related workers",41092,20909,20183,90051,93580,85214
2022,"Agricultural and food science technicians",37352,24576,12776,53646,55667,48415
2022,"Biological technicians",18891,8815,10076,57468,58397,56593
2022,"Chemical technicians",55660,36798,18862,59048,61602,55475
2022,"Environmental science and geoscience technicians",15088,11425,3663,63780,70601,55049
2022,"Nuclear technicians",3425,2729,696,96273,96460,92280
2022,"Social science research assistants",5878,2636,3242,55355,57102,48654
2022,"Other life, physical, and social science technicians",172353,83706,88647,51591,53818,49412
2022,"Occupational health and safety specialists and technicians",85580,57163,28417,72787,75724,68057
2022,"Education, Legal, Community Service, Arts, and Media Occupations:",12252605,4462374,7790231,60541,70370,56064
2022,"Community and Social Service Occupations:",2106009,729606,1376403,54126,54946,53745
2022,"Substance abuse and behavioral disorder counselors",91092,25245,65847,52556,51202,53313
2022,"Educational, guidance, and career counselors and advisors",282549,67892,214657,58798,60070,58479
2022,"Marriage and family therapists",15121,3679,11442,61890,61027,62162
2022,"Mental health counselors",118601,29016,89585,57030,59080,56376
2022,"Rehabilitation counselors",17884,5809,12075,57939,63433,56611
2022,"Counselors, all other",135346,45623,89723,51684,56216,50474
2022,"Child, family, and school social workers",68385,11440,56945,50975,53292,50657
2022,"Healthcare social workers",68726,13559,55167,56461,55330,56811
2022,"Mental health and substance abuse social workers",29135,4073,25062,63678,66049,63399
2022,"Social workers, all other",481554,78305,403249,57061,58100,56833
2022,"Probation officers and correctional treatment specialists",71868,30331,41537,59320,63247,58035
2022,"Social and human service assistants",184923,42545,142378,44409,47519,43698
2022,"Other community and social service specialists",84475,25171,59304,52913,61299,50408
2022,"Clergy",357534,303616,53918,52534,52968,50724
2022,"Directors, religious activities and education",53256,23722,29534,53396,59830,48760
2022,"Religious workers, all other",45560,19580,25980,40583,45061,37335
2022,"Legal Occupations:",1621996,759033,862963,105410,150658,80673
2022,"Lawyers",1036761,637005,399756,153540,162510,134805
2022,"Judicial law clerks",19966,4292,15674,61064,73449,57254
2022,"Judges, magistrates, and other judicial workers",61766,28714,33052,122830,147752,100993
2022,"Paralegals and legal assistants",377255,54720,322535,57195,55722,57420
2022,"Title examiners, abstractors, and searchers",85785,20749,65036,55099,83353,52229
2022,"Legal support workers, all other",40463,13553,26910,58117,62558,57480
2022,"Educational Instruction, and Library Occupations:",6389431,1823649,4565782,56913,66043,53519
2022,"Postsecondary teachers",926405,480523,445882,81492,88740,75212
2022,"Preschool and kindergarten teachers",518739,13288,505451,34625,38933,34472
2022,"Elementary and middle school teachers",2267573,467639,1799934,58625,62514,57590
2022,"Secondary school teachers",966451,423136,543315,63636,66453,61448
2022,"Special education teachers",298468,43741,254727,58915,61105,58527
2022,"Tutors",23991,7643,16348,35242,26756,36227
2022,"Other teachers and instructors",390274,180142,210132,54686,62956,49175
2022,"Archivists, curators, and museum technicians",59778,27011,32767,63006,66255,60163
2022,"Librarians and media collections specialists",151697,33331,118366,59774,60830,59444
2022,"Library technicians",13177,3478,9699,36159,38700,33480
2022,"Teaching assistants",653135,115145,537990,27426,33387,26511
2022,"Other educational instruction and library workers",119743,28572,91171,65173,75534,62714
2022,"Arts, Design, Entertainment, Sports, and Media Occupations:",2135169,1150086,985083,63876,67623,60840
2022,"Artists and related workers",181001,106707,74294,52653,62407,42772
2022,"Commercial and industrial designers",12508,9554,2954,77064,74640,77891
2022,"Fashion designers",18463,3218,15245,58626,88724,56181
2022,"Floral designers",31319,3997,27322,35924,42387,35201
2022,"Graphic designers",229189,111263,117926,58685,62654,55657
2022,"Interior designers",79579,16285,63294,63006,59117,63763
2022,"Merchandise displayers and window trimmers",20746,8529,12217,36589,37153,35946
2022,"Other designers",298518,181424,117094,76578,81272,70319
2022,"Actors",15494,9132,6362,49060,44656,49659
2022,"Producers and directors",167133,103646,63487,81166,82973,78363
2022,"Athletes and sports competitors",22652,19838,2814,63959,62924,79397
2022,"Coaches and scouts",132754,84572,48182,53963,56604,50726
2022,"Umpires, referees, and other sports officials",3251,2368,883,48447,72930,17119
2022,"Dancers and choreographers",7129,2051,5078,51837,39542,52434
2022,"Music directors and composers",25869,19665,6204,54232,55261,53399
2022,"Musicians and singers",44487,33605,10882,47054,50507,38804
2022,"Disc jockeys, except radio",6954,6426,528,37734,37356,40802
2022,"Entertainers and performers, sports and related workers, all other",15150,8774,6376,41540,51148,37899
2022,"Broadcast announcers and radio disc jockeys",16281,10838,5443,63795,69747,60047
2022,"News analysts, reporters, and journalists",64582,35469,29113,67721,68568,67336
2022,"Public relations specialists",131938,47789,84149,81373,91028,76835
2022,"Editors",98889,42287,56602,68665,70591,67529
2022,"Technical writers",49967,21913,28054,85795,87478,82147
2022,"Writers and authors",146504,65251,81253,69355,70712,67291
2022,"Interpreters and translators",49034,14446,34588,47489,52010,44206
2022,"Court reporters and simultaneous captioners",22611,2485,20126,69468,62289,70078
2022,"Media and communication workers, all other",17085,8173,8912,74522,70352,78983
2022,"Broadcast, sound, and lighting technicians",70890,64821,6069,61992,63222,56296
2022,"Photographers",89594,52381,37213,48595,52014,41408
2022,"Television, video, and film camera operators and editors",64131,51814,12317,62337,61917,64202
2022,"Healthcare Practitioners and Technical Occupations:",7555731,2062441,5493290,76047,95762,72119
2022,"Chiropractors",49704,35647,14057,85446,91442,64268
2022,"Dentists",107523,73136,34387,186740,200421,158308
2022,"Dietitians and nutritionists",75139,8822,66317,63255,59936,63446
2022,"Optometrists",31705,18464,13241,129937,140450,123300
2022,"Pharmacists",270137,116667,153470,130580,136253,128132
2022,"Physician assistants",128908,46373,82535,121105,135113,115573
2022,"Podiatrists",11024,8400,2624,158263,157855,161157
2022,"Audiologists",16664,2473,14191,87161,102026,86087
2022,"Occupational therapists",104462,14335,90127,77984,93640,76619
2022,"Physical therapists",208175,87749,120426,86325,93258,82476
2022,"Radiation therapists",9758,2711,7047,88149,96035,81293
2022,"Recreational therapists",8910,1930,6980,47108,60696,44525
2022,"Respiratory therapists",96545,36278,60267,73880,81234,71223
2022,"Speech-language pathologists",129314,7358,121956,73224,82439,72470
2022,"Exercise physiologists",5742,2673,3069,50313,52080,46671
2022,"Therapists, all other",157845,30299,127546,59513,61237,58782
2022,"Veterinarians",78560,28990,49570,121562,134325,115521
2022,"Registered nurses",2607050,359266,2247784,78932,84879,77582
2022,"Nurse anesthetists",36383,16431,19952,202182,208895,197523
2022,"Nurse practitioners",223275,29247,194028,116044,127337,114981
2022,"Acupuncturists",9171,3162,6009,64995,69136,62294
2022,"Healthcare diagnosing or treating practitioners, all other",5346,1429,3917,45932,96354,44128
2022,"Clinical laboratory technologists and technicians",269700,80377,189323,54331,57720,52635
2022,"Dental hygienists",86924,6767,80157,69959,104097,68169
2022,"Cardiovascular technologists and technicians",39541,14883,24658,61786,83642,51279
2022,"Diagnostic medical sonographers",71695,18023,53672,80488,100457,77120
2022,"Radiologic technologists and technicians",180681,62667,118014,64935,72316,62137
2022,"Magnetic resonance imaging technologists",45143,20322,24821,82175,89959,78825
2022,"Nuclear medicine technologists and medical dosimetrists",29248,15768,13480,104231,114031,99444
2022,"Emergency medical technicians",101055,59902,41153,42511,44647,39461
2022,"Paramedics",96527,67216,29311,66001,69149,60973
2022,"Pharmacy technicians",289611,69767,219844,39142,41503,38225
2022,"Psychiatric technicians",68054,18300,49754,38620,42302,36858
2022,"Surgical technologists",76188,18850,57338,52349,60028,50748
2022,"Veterinary technologists and technicians",120134,12632,107502,36428,41083,36111
2022,"Dietetic technicians and ophthalmic medical technicians",29782,6155,23627,34896,37646,34290
2022,"Licensed practical and licensed vocational nurses",434662,49962,384700,50437,54220,50039
2022,"Medical records specialists",165261,14853,150408,48402,62677,47679
2022,"Opticians, dispensing",46656,14721,31935,45338,52925,42558
2022,"Miscellaneous health technologists and technicians",122797,43480,79317,47177,57628,43235
2022,"Other healthcare practitioners and technical occupations",89704,29886,59818,61051,65991,59509
2022,"Healthcare Support Occupations:",3043706,509885,2533821,35335,39160,34691
2022,"Home health aides",261817,35230,226587,31967,34586,31744
2022,"Personal care aides",764521,157720,606801,31940,34527,31605
2022,"Nursing assistants",811196,105076,706120,33943,37869,33341
2022,"Orderlies and psychiatric aides",47801,28774,19027,36091,36506,35344
2022,"Occupational therapy assistants and aides",31540,6637,24903,45199,54711,41946
2022,"Physical therapist assistants and aides",74517,26973,47544,51123,51734,50768
2022,"Massage therapists",56993,14922,42071,39057,41927,37558
2022,"Dental assistants",191514,13126,178388,37410,46858,37080
2022,"Medical assistants",465770,41162,424608,37053,40256,36930
2022,"Medical transcriptionists",19435,2967,16468,31004,18416,33063
2022,"Pharmacy aides",23074,6216,16858,39272,42692,38750
2022,"Veterinary assistants and laboratory animal caretakers",50948,8182,42766,32269,37670,31684
2022,"Phlebotomists",101559,17136,84423,38768,42319,37723
2022,"Other healthcare support workers",143021,45764,97257,42127,50501,39449
2022,"Protective Service Occupations:",2713817,2175087,538730,62004,64749,50411
2022,"First-line supervisors of correctional officers",37625,25871,11754,65477,71318,56946
2022,"First-line supervisors of police and detectives",90789,76478,14311,96540,101381,76515
2022,"First-line supervisors of firefighting and prevention workers",54918,52862,2056,104238,105051,100436
2022,"First-line supervisors of security workers",70684,50729,19955,62698,70114,50207
2022,"First-line supervisors of protective service workers, all other",3275,2280,995,86258,93803,64372
2022,"Firefighters",323153,306960,16193,77897,78369,70174
2022,"Fire inspectors",26258,23547,2711,72207,72163,72702
2022,"Bailiffs",21671,15015,6656,61087,61309,60858
2022,"Correctional officers and jailers",288930,210944,77986,57250,60376,49947
2022,"Detectives and criminal investigators",134308,98355,35953,91309,95839,82150
2022,"Fish and game wardens",8848,8028,820,64097,65987,62990
2022,"Parking enforcement workers",5293,3726,1567,49192,49970,46356
2022,"Police officers",772084,664790,107294,75312,77017,64004
2022,"Animal control workers",7040,4380,2660,44010,40054,47627
2022,"Private detectives and investigators",98592,50303,48289,63832,73665,55552
2022,"Security guards and gambling surveillance officers",682764,530934,151830,38977,40021,36032
2022,"Crossing guards and flaggers",13006,8801,4205,37087,39571,32354
2022,"Transportation security screeners",31862,20340,11522,48817,51035,45231
2022,"School bus monitors",11736,1124,10612,27271,28949,27091
2022,"Other protective service workers",30981,19620,11361,41309,46536,34628
2022,"Food Preparation and Serving Related Occupations:",3352373,1759798,1592575,30448,32097,27393
2022,"Chefs and head cooks",350589,280063,70526,41162,42271,36114
2022,"First-line supervisors of food preparation and serving workers",325460,137696,187764,34348,39145,31326
2022,"Cooks",1066428,659827,406601,28866,30497,26278
2022,"Food preparation workers",329509,136027,193482,26966,28536,26250
2022,"Bartenders",205622,104293,101329,37187,40614,34599
2022,"Fast food and counter workers",196440,74695,121745,25493,27504,24846
2022,"Waiters and waitresses",588675,216293,372382,30000,32411,27070
2022,"Food servers, nonrestaurant",74727,29713,45014,29730,29674,29753
2022,"Dining room and cafeteria attendants and bartender helpers",73246,35119,38127,25902,28472,23785
2022,"Dishwashers",91285,71684,19601,26007,26381,23978
2022,"Hosts and hostesses, restaurant, lounge, and coffee shop",43548,10790,32758,26295,30323,25477
2022,"Food preparation and serving related workers, all other",6844,3598,3246,26950,27485,25294
2022,"Building and Grounds Cleaning and Maintenance Occupations:",3258466,2164053,1094413,34080,37239,29141
2022,"First-line supervisors of housekeeping and janitorial workers",180417,102480,77937,45454,51616,38773
2022,"First-line supervisors of landscaping, lawn service, and groundskeeping workers",132818,122152,10666,49384,49706,46521
2022,"Janitors and building cleaners",1438528,1010792,427736,34389,37216,29297
2022,"Maids and housekeeping cleaners",641801,112470,529331,28253,32074,27215
2022,"Pest control workers",83839,77939,5900,43601,44103,40791
2022,"Landscaping and groundskeeping workers",693110,654085,39025,33603,34036,29617
2022,"Tree trimmers and pruners",75766,72872,2894,41539,41514,47500
2022,"Other grounds maintenance workers",12187,11263,924,38576,39916,35720
2022,"Personal Care and Service Occupations:",1848587,529611,1318976,33756,40014,31713
2022,"Supervisors of personal care and service workers",41393,20413,20980,51622,54841,46389
2022,"Animal trainers",37531,15778,21753,35230,40882,31347
2022,"Animal caretakers",160405,44743,115662,32127,36633,31277
2022,"Gambling services workers",61595,37221,24374,46786,49199,42957
2022,"Ushers, lobby attendants, and ticket takers",6272,2789,3483,30673,24911,35054
2022,"Other entertainment attendants and related workers",60712,35140,25572,33301,33870,32660
2022,"Embalmers, crematory operators and funeral attendants",11737,7949,3788,40189,42307,31977
2022,"Morticians, undertakers, and funeral arrangers",36592,24063,12529,62682,69717,52754
2022,"Barbers",83677,67965,15712,31446,31947,28297
2022,"Hairdressers, hairstylists, and cosmetologists",389613,42836,346777,35435,42387,34470
2022,"Manicurists and pedicurists",166605,38464,128141,30404,32855,28284
2022,"Skincare specialists",51760,1527,50233,38826,22116,39295
2022,"Other personal appearance workers",11158,1144,10014,31674,41740,30946
2022,"Baggage porters, bellhops, and concierges",62045,46024,16021,38753,42504,34545
2022,"Tour and travel guides",18514,11128,7386,41393,41499,39603
2022,"Childcare workers",391950,18982,372968,27034,36302,26820
2022,"Exercise trainers and group fitness instructors",89723,48141,41582,40982,41796,40103
2022,"Recreation workers",79705,25277,54428,37839,42696,35189
2022,"Residential advisors",26995,11491,15504,36536,37026,35429
2022,"Personal care and service workers, all other",60605,28536,32069,33727,31877,36343
2022,"Sales and Related Occupations:",9812069,5706063,4106006,53543,63240,42808
2022,"First-Line supervisors of retail sales workers",2487276,1414992,1072284,51220,57730,43654
2022,"First-Line supervisors of non-retail sales workers",1008909,632045,376864,70620,75161,63169
2022,"Cashiers",976641,310156,666485,27174,30290,26362
2022,"Counter and rental clerks",41478,26360,15118,40551,42288,36658
2022,"Parts salespersons",96452,81980,14472,44241,45276,40616
2022,"Retail salespersons",1647053,1030492,616561,41498,47582,34094
2022,"Advertising sales agents",89469,46972,42497,76977,80735,72974
2022,"Insurance sales agents",502598,248551,254047,59999,76553,50297
2022,"Securities, commodities, and financial services sales agents",206990,152236,54754,111951,136388,75096
2022,"Travel agents",38810,8596,30214,46454,46293,46567
2022,"Sales representatives of services, except advertising, insurance, financial services, and travel",596182,425701,170481,83377,90555,70422
2022,"Sales representatives, wholesale and manufacturing",1058819,779159,279660,78987,82319,66587
2022,"Models, demonstrators, and product promoters",10302,3684,6618,41621,48933,40143
2022,"Real estate brokers and sales agents",655760,318831,336929,77013,84043,68174
2022,"Sales engineers",50251,45359,4892,127221,129371,113766
2022,"Telemarketers",16248,5706,10542,34728,36238,33773
2022,"Door-to-door sales workers, news and street vendors, and related workers",38869,23154,15715,41300,45696,33846
2022,"Sales and related workers, all other",289962,152089,137873,50709,61359,41194
2022,"Office and Administrative Support Occupations:",12196123,3378577,8817546,44038,50124,42303
2022,"First-Line supervisors of office and administrative support workers",953207,323571,629636,57333,66794,53106
2022,"Switchboard operators, including answering service",11874,2928,8946,40252,48845,39214
2022,"Telephone operators",15731,6116,9615,39341,47477,35736
2022,"Communications equipment operators, all other",5668,3095,2573,51271,51447,51014
2022,"Bill and account collectors",105008,27962,77046,42864,44797,42284
2022,"Billing and posting clerks",370927,48936,321991,41977,50728,41328
2022,"Bookkeeping, accounting, and auditing clerks",850499,115992,734507,47035,51198,46557
2022,"Gambling cage workers",7341,2408,4933,31780,31393,32494
2022,"Payroll and timekeeping clerks",124075,16920,107155,51778,53940,51433
2022,"Procurement clerks",36330,17550,18780,61387,64556,57749
2022,"Tellers",167582,23650,143932,33782,36047,33404
2022,"Financial clerks, all other",104481,39337,65144,61535,88556,51929
2022,"Brokerage clerks",5847,1654,4193,53382,61194,47374
2022,"Correspondence clerks",4848,1518,3330,45744,54600,41658
2022,"Court, municipal, and license clerks",73774,12604,61170,44356,52170,43050
2022,"Credit authorizers, checkers, and clerks",34485,10482,24003,44388,58500,42936
2022,"Customer service representatives",2108914,696037,1412877,41370,45658,40097
2022,"Eligibility interviewers, government programs",77316,15366,61950,50543,60667,48354
2022,"File clerks",96686,24360,72326,41600,42364,41383
2022,"Hotel, motel, and resort desk clerks",70171,28886,41285,29720,31783,27806
2022,"Interviewers, except eligibility and loan",137223,30032,107191,37872,38935,37468
2022,"Library assistants, clerical",39045,9004,30041,38400,44515,36641
2022,"Loan interviewers and clerks",134100,29804,104296,53499,55997,52955
2022,"New accounts clerks",9954,2997,6957,42090,69491,40597
2022,"Order clerks",65223,30838,34385,40953,42307,40105
2022,"Human resources assistants, except payroll and timekeeping",82093,17075,65018,58281,71021,56287
2022,"Receptionists and information clerks",750839,80272,670567,34559,39448,34147
2022,"Reservation and transportation ticket agents and travel clerks",90388,45249,45139,45994,49818,41464
2022,"Information and record clerks, all other",75570,19136,56434,42195,50717,41292
2022,"Cargo and freight agents",20152,10986,9166,50410,61508,41851
2022,"Couriers and messengers",338721,271688,67033,39075,41323,31434
2022,"Public safety telecommunicators",89011,31609,57402,49822,53644,47478
2022,"Dispatchers, except police, fire, and ambulance",162023,74151,87872,46014,52101,41487
2022,"Meter readers, utilities",15812,14185,1627,48302,48833,36174
2022,"Postal service clerks",108218,50954,57264,57431,62120,52300
2022,"Postal service mail carriers",301244,188178,113066,61859,64813,56680
2022,"Postal service mail sorters, processors, and processing machine operators",50805,27976,22829,52996,55348,50992
2022,"Production, planning, and expediting clerks",239078,117293,121785,59645,68540,50161
2022,"Shipping, receiving, and inventory clerks",514600,342668,171932,39681,41324,36061
2022,"Weighers, measurers, checkers, and samplers, recordkeeping",64622,36504,28118,42892,49678,38743
2022,"Executive secretaries and executive administrative assistants",238929,13612,225317,66457,63168,66750
2022,"Legal secretaries and administrative assistants",49918,2368,47550,55072,60891,54249
2022,"Medical secretaries and administrative assistants",100514,8551,91963,40976,41143,40972
2022,"Secretaries and administrative assistants, except legal, medical, and executive",1505203,104869,1400334,43554,50397,43062
2022,"Data entry keyers",199714,49798,149916,39117,42294,38204
2022,"Word processors and typists",18546,2632,15914,39859,44432,38796
2022,"Desktop publishers",1958,1211,747,62270,73448,50724
2022,"Insurance claims and policy processing clerks",209533,37511,172022,43916,52352,42396
2022,"Mail clerks and mail machine operators, except postal service",35948,18444,17504,36818,39923,35025
2022,"Office clerks, general",821193,146046,675147,40976,43344,40659
2022,"Office machine operators, except computer",19501,8849,10652,36252,41003,31554
2022,"Proofreaders and copy markers",6456,1457,4999,46136,53507,42373
2022,"Statistical assistants",23890,11685,12205,61689,64470,59542
2022,"Office and administrative support workers, all other",451335,121573,329762,47979,54109,46177
2022,"Natural Resources, Construction, and Maintenance Occupations:",10738294,10288762,449532,51155,51568,37784
2022,"Farming, Fishing, and Forestry Occupations:",599195,478411,120784,35511,37396,29304
2022,"First-line supervisors of farming, fishing, and forestry workers",40401,34810,5591,53892,54908,45011
2022,"Agricultural inspectors",10816,7309,3507,51558,54320,48915
2022,"Animal breeders",6161,4211,1950,39600,41198,36541
2022,"Graders and sorters, agricultural products",32517,11241,21276,32162,41573,30267
2022,"Miscellaneous agricultural workers",437891,353605,84286,32681,35187,27054
2022,"Fishing and hunting workers",20879,19980,899,44273,44817,41622
2022,"Forest and conservation workers",12887,10573,2314,44896,48045,34028
2022,"Logging workers",37643,36682,961,41369,41561,29128
2022,"Construction and Extraction Occupations:",5992219,5806646,185573,50311,50558,40164
2022,"First-line supervisors of construction trades and extraction workers",587435,565155,22280,65656,66251,52112
2022,"Brickmasons, blockmasons, and stonemasons",90674,89868,806,46331,46505,25968
2022,"Carpenters",886647,869538,17109,46349,46567,32484
2022,"Carpet, floor, and tile installers and finishers",96342,92820,3522,41543,41648,34855
2022,"Cement masons, concrete finishers, and terrazzo workers",38585,38093,492,50305,50417,33804
2022,"Construction laborers",1255611,1212160,43451,41059,41197,35888
2022,"Construction equipment operators",318887,310548,8339,54533,54658,46865
2022,"Drywall installers, ceiling tile installers, and tapers",90045,86600,3445,41895,42135,33424
2022,"Electricians",824589,808472,16117,60520,60671,50310
2022,"Glaziers",39110,38468,642,51007,51123,37593
2022,"Insulation workers",35301,34106,1195,46916,47537,30753
2022,"Painters and paperhangers",376244,348688,27556,40040,40449,31832
2022,"Pipelayers",43677,43138,539,48787,48726,50949
2022,"Plumbers, pipefitters, and steamfitters",511269,504122,7147,56011,56056,54722
2022,"Roofers",135365,131660,3705,42398,42546,26437
2022,"Sheet metal workers",112911,108376,4535,51193,51666,42055
2022,"Structural iron and steel workers",47691,46854,837,62047,62083,58690
2022,"Helpers, construction trades",27323,24892,2431,35690,35414,36921
2022,"Construction and building inspectors",95228,87109,8119,64488,66071,50749
2022,"Elevator and escalator installers and repairers",28847,28510,337,100748,101064,35354
2022,"Fence erectors",21258,20708,550,41048,41146,24784
2022,"Hazardous materials removal workers",18283,13521,4762,49931,52492,38333
2022,"Highway maintenance workers",65146,64231,915,45332,45431,39089
2022,"Septic tank servicers and sewer pipe cleaners",7298,7065,233,48667,51338,45216
2022,"Miscellaneous construction and related workers",34834,33136,1698,40408,40694,32062
2022,"Excavating and loading machine and dragline operators, surface mining",6566,6325,241,54145,54124,54232
2022,"Earth drillers, except oil and gas",21304,21078,226,56774,56919,32335
2022,"Explosives workers, ordnance handling experts, and blasters",7492,7249,243,70883,71451,49495
2022,"Underground mining machine operators",41889,41271,618,73182,73552,61857
2022,"Other extraction workers",49091,46572,2519,54727,54564,65873
2022,"Installation, Maintenance, and Repair Occupations:",4146880,4003705,143175,54671,54928,46973
2022,"First-line supervisors of mechanics, installers, and repairers",225532,208816,16716,71232,72012,61551
2022,"Computer, automated teller, and office machine repairers",105686,95986,9700,49876,50540,44035
2022,"Radio and telecommunications equipment installers and repairers",137710,129091,8619,61286,61800,45547
2022,"Avionics technicians",17554,16393,1161,74105,75104,54856
2022,"Electric motor, power tool, and related repairers",22368,21376,992,52983,53667,29200
2022,"Electrical and electronics repairers, industrial and utility",13922,13411,511,95688,96087,39622
2022,"Electronic equipment installers and repairers, motor vehicles",5866,5701,165,48694,48905,23323
2022,"Audiovisual equipment installers and repairers",36661,35315,1346,49440,48998,55980
2022,"Security and fire alarm systems installers",59424,57597,1827,56003,56185,42956
2022,"Aircraft mechanics and service technicians",131694,126061,5633,72525,72940,54569
2022,"Automotive body and related repairers",106672,104152,2520,52353,52575,33088
2022,"Automotive glass installers and repairers",17953,17408,545,41711,42145,34300
2022,"Automotive service technicians and mechanics",722935,711420,11515,46828,46875,43097
2022,"Bus and truck mechanics and diesel engine specialists",276338,273305,3033,55588,55837,41547
2022,"Heavy vehicle and mobile equipment service technicians and mechanics",190160,187951,2209,61531,61809,35116
2022,"Small engine mechanics",33219,32683,536,44166,43833,60846
2022,"Miscellaneous vehicle and mobile equipment mechanics, installers, and repairers",68875,66032,2843,36325,36218,37124
2022,"Control and valve installers and repairers",25716,24244,1472,59300,59849,50414
2022,"Heating, air conditioning, and refrigeration mechanics and installers",400426,395599,4827,53619,53686,41929
2022,"Home appliance repairers",31862,30211,1651,47152,46240,51113
2022,"Industrial and refractory machinery mechanics",303656,291173,12483,61964,62445,51370
2022,"Maintenance and repair workers, general",648016,622312,25704,52655,53041,40931
2022,"Maintenance workers, machinery",21502,21079,423,60444,59828,73073
2022,"Millwrights",40213,39088,1125,74239,74766,62763
2022,"Electrical power-line installers and repairers",119941,115252,4689,88826,90177,48409
2022,"Telecommunications line installers and repairers",99840,96640,3200,62675,62919,57167
2022,"Precision instrument and equipment repairers",56025,49890,6135,60462,62192,46099
2022,"Coin, vending, and amusement machine servicers and repairers",22030,20364,1666,41290,41975,32476
2022,"Commercial divers",2148,1804,344,55321,55705,31786
2022,"Locksmiths and safe repairers",22207,21430,777,48619,49108,32015
2022,"Riggers",9818,9153,665,60975,61090,59729
2022,"Helpers--installation, maintenance, and repair workers",13927,12948,979,36476,36851,35151
2022,"Other installation, maintenance, and repair workers",148367,141211,7156,46377,46755,39800
2022,"Production Occupations:",7019626,5178333,1841293,45073,49667,36546
2022,"First-line supervisors of production and operating workers",735946,579940,156006,62739,65965,48658
2022,"Aircraft structure, surfaces, rigging, and systems assemblers",4007,3203,804,59706,62619,54013
2022,"Electrical, electronics, and electromechanical assemblers",96346,54745,41601,38938,41395,35661
2022,"Engine and other machine assemblers",10146,8751,1395,51877,53557,37116
2022,"Structural metal fabricators and fitters",21472,20922,550,49442,49713,45714
2022,"Other assemblers and fabricators",816433,533770,282663,40703,42361,37117
2022,"Bakers",134647,57707,76940,32795,35590,31289
2022,"Butchers and other meat, poultry, and fish processing workers",200321,158504,41817,39117,40790,34280
2022,"Food and tobacco roasting, baking, and drying machine operators and tenders",8229,6412,1817,43297,44237,37050
2022,"Food batchmakers",56430,23470,32960,35818,43270,32834
2022,"Food cooking machine operators and tenders",8281,6287,1994,31686,34354,28413
2022,"Food processing workers, all other",120047,82733,37314,42152,45556,37864
2022,"Computer numerically controlled tool operators and programmers",80888,72739,8149,51809,52676,40620
2022,"Forming machine setters, operators, and tenders, metal and plastic",25866,22125,3741,47960,48488,43043
2022,"Cutting, punching, and press machine setters, operators, and tenders, metal and plastic",53903,45834,8069,41869,43473,34254
2022,"Grinding, lapping, polishing, and buffing machine tool setters, operators, and tenders, metal and plastic",33725,30152,3573,41493,42074,31515
2022,"Other machine tool setters, operators, and tenders, metal and plastic",7862,6916,946,43667,45460,32669
2022,"Machinists",315087,301770,13317,54272,54838,36639
2022,"Metal furnace operators, tenders, pourers, and casters",19486,17235,2251,54965,56395,41226
2022,"Model makers and patternmakers, metal and plastic",2718,1987,731,52818,56145,35517
2022,"Molders and molding machine setters, operators, and tenders, metal and plastic",29005,24975,4030,44009,47414,36238
2022,"Tool and die makers",45164,43946,1218,64908,65516,38423
2022,"Welding, soldering, and brazing workers",483309,457887,25422,48612,49245,40787
2022,"Other metal workers and plastic workers",341444,269488,71956,43225,45769,37372
2022,"Prepress technicians and workers",14515,9144,5371,48152,51066,44088
2022,"Printing press operators",105703,84789,20914,43036,45656,31649
2022,"Print binding and finishing workers",6660,4757,1903,41475,43740,35741
2022,"Laundry and dry-cleaning workers",78035,27874,50161,28776,31965,26862
2022,"Pressers, textile, garment, and related materials",17013,9899,7114,32397,43983,28988
2022,"Sewing machine operators",85647,26944,58703,32220,33081,31883
2022,"Shoe and leather workers",8768,5304,3464,32068,37157,26817
2022,"Tailors, dressmakers, and sewers",33832,11414,22418,36183,39733,35415
2022,"Textile machine setters, operators, and tenders",12713,7113,5600,32399,35208,31595
2022,"Upholsterers",22471,17246,5225,36638,38922,30689
2022,"Other textile, apparel, and furnishings workers",13376,8310,5066,43727,48996,42610
2022,"Cabinetmakers and bench carpenters",41548,38369,3179,42935,44099,27887
2022,"Furniture finishers",8729,7589,1140,42069,42474,38378
2022,"Sawing machine setters, operators, and tenders, wood",19186,17694,1492,37929,37408,41195
2022,"Woodworking machine setters, operators, and tenders, except sawing",14345,11652,2693,38192,39039,35965
2022,"Other woodworkers",26885,24208,2677,42217,42096,44425
2022,"Power plant operators, distributors, and dispatchers",47767,44032,3735,106644,106570,113352
2022,"Stationary engineers and boiler operators",85146,82263,2883,71639,71955,67368
2022,"Water and wastewater treatment plant and system operators",94097,90559,3538,58267,58264,58317
2022,"Miscellaneous plant and system operators",41358,38644,2714,85093,83978,90059
2022,"Chemical processing machine setters, operators, and tenders",71451,62159,9292,57561,59017,42215
2022,"Crushing, grinding, polishing, mixing, and blending workers",63738,57099,6639,50067,50893,41344
2022,"Cutting workers",47959,35512,12447,38294,39666,33708
2022,"Extruding, forming, pressing, and compacting machine setters, operators, and tenders",21968,17867,4101,44584,48087,32503
2022,"Furnace, kiln, oven, drier, and kettle operators and tenders",9788,7795,1993,51371,57159,36413
2022,"Inspectors, testers, sorters, samplers, and weighers",699757,440509,259248,48725,55163,40573
2022,"Jewelers and precious stone and metal workers",30095,19291,10804,41976,46905,35888
2022,"Dental and ophthalmic laboratory technicians and medical appliance technicians",67860,29782,38078,42269,50708,37570
2022,"Packaging and filling machine operators and tenders",196347,92667,103680,36241,40622,33571
2022,"Painting workers",116186,105601,10585,45085,45988,41332
2022,"Photographic process workers and processing machine operators",21653,13800,7853,74414,85451,57232
2022,"Adhesive bonding machine operators and tenders",9222,6466,2756,43641,45423,36524
2022,"Etchers and engravers",5827,3707,2120,48060,50187,47922
2022,"Molders, shapers, and casters, except metal and plastic",20795,17961,2834,42496,42806,35364
2022,"Paper goods machine setters, operators, and tenders",16603,13865,2738,47270,50297,32048
2022,"Tire builders",12077,11423,654,52417,52318,57568
2022,"Helpers--production workers",39353,28822,10531,33553,34594,31652
2022,"Other production equipment operators and tenders",7919,7150,769,46932,49250,36584
2022,"Other production workers",1132472,807555,324917,41502,44766,35137
2022,"Transportation and Material Moving Occupations:12",8331203,6823161,1508042,42070,44860,33560
2022,"Transportation Occupations:",4340588,3853734,486854,51768,53242,38252
2022,"Supervisors of transportation and material moving workers",285052,213950,71102,54626,59654,42902
2022,"Aircraft pilots and flight engineers",111069,104863,6206,128652,131647,94593
2022,"Air traffic controllers and airfield operations specialists",29350,23364,5986,110239,114451,102283
2022,"Flight attendants",54758,15743,39015,53980,60226,51583
2022,"Ambulance drivers and attendants, except emergency medical technicians",5989,4103,1886,40411,41829,31395
2022,"Bus drivers, school",108128,52067,56061,35095,38930,32168
2022,"Bus drivers, transit and intercity",153426,108057,45369,50381,53593,40121
2022,"Driver/sales workers and truck drivers",2910524,2744927,165597,52583,53448,37058
2022,"Shuttle drivers and chauffeurs",39410,34135,5275,40367,40879,35817
2022,"Taxi drivers",226317,199158,27159,37612,39361,26698
2022,"Motor vehicle operators, all other",84738,68130,16608,36621,37660,33197
2022,"Locomotive engineers and operators",41554,40453,1101,88959,90034,58599
2022,"Railroad conductors and yardmasters",38772,35217,3555,79756,81097,52058
2022,"Other rail transportation workers",19935,17894,2041,74152,73664,82202
2022,"Sailors and marine oilers",15453,14119,1334,55620,54843,58512
2022,"Ship and boat captains and operators",24878,23125,1753,81238,81264,80712
2022,"Ship engineers",2019,1942,77,66195,66009,81250
2022,"Parking attendants",34963,31770,3193,32249,32787,27471
2022,"Transportation service attendants",65101,53534,11567,32168,33972,27005
2022,"Transportation inspectors",40054,34424,5630,68704,73098,50419
2022,"Passenger attendants",15394,6719,8675,31669,37392,30808
2022,"Other transportation workers",33704,26040,7664,55678,61763,48113
2022,"Material Moving Occupations:",3990615,2969427,1021188,36154,37573,32174
2022,"Crane and tower operators",56063,55158,905,70881,71364,48781
2022,"Conveyor, dredge, and hoist and winch operators",20120,19304,816,55735,57880,28992
2022,"Industrial truck and tractor operators",560111,508558,51553,40729,40906,37411
2022,"Cleaners of vehicles and equipment",220669,181122,39547,32399,32955,30598
2022,"Laborers and freight, stock, and material movers, hand",1612118,1256445,355673,36862,38274,32812
2022,"Machine feeders and offbearers",19451,10475,8976,37658,42766,32088
2022,"Packers and packagers, hand",357854,158333,199521,31670,33162,30831
2022,"Stockers and order fillers",996750,646932,349818,32973,33618,32106
2022,"Pumping station operators",19572,19045,527,68785,69880,61796
2022,"Refuse and recyclable material collectors",70278,63055,7223,40217,41442,28104
2022,"Other material moving workers",57629,51000,6629,43451,44626,37971
2023,"Chief executives",1261,854,407,150852,155116,131040
2023,"General and operations managers",1222,767,456,80288,87828,70044
2023,"Marketing managers",508,188,320,94224,99372,90792
2023,"Sales managers",566,390,176,104208,119444,87776
2023,"Computer and information systems managers",781,569,212,119756,120276,113984
2023,"Financial managers",1355,607,748,91364,109200,77844
2023,"Human resources managers",324,79,245,91312,98332,88712
2023,"Purchasing managers",234,129,105,90532,97708,82420
2023,"Transportation, storage, and distribution managers",360,277,83,65624,68536,63388
2023,"Construction managers",693,611,82,87360,90844,74412
2023,"Education and childcare administrators",941,294,647,81380,97240,76388
2023,"Food service managers",720,384,336,51376,58292,48048
2023,"Medical and health services managers",767,224,543,84968,99528,80080
2023,"Property, real estate, and community association managers",489,189,300,65676,79092,59436
2023,"Social and community service managers",410,113,297,71864,78052,69732
2023,"Managers, all other",3872,2263,1609,90376,98124,79872
2023,"Business and financial operations occupations",8227,3694,4533,78884,87048,73112
2023,"Wholesale and retail buyers, except farm products",141,57,84,58500,66040,53508
2023,"Purchasing agents, except wholesale, retail, and farm products",287,134,153,71240,78728,63232
2023,"Claims adjusters, appraisers, examiners, and investigators",367,153,214,71240,76336,67912
2023,"Compliance officers",314,145,169,75816,83044,71604
2023,"Human resources workers",893,226,667,66196,71084,65468
2023,"Training and development specialists",144,63,80,69784,85696,63544
2023,"Logisticians",182,105,78,58760,62764,51688
2023,"Project management specialists",886,481,405,94172,99788,86372
2023,"Management analysts",714,360,354,98280,103636,94484
2023,"Market research analysts and marketing specialists",416,164,252,82680,92092,80704
2023,"Business operations specialists, all other",474,212,262,76180,90324,63648
2023,"Accountants and auditors",1394,587,807,80756,85488,78208
2023,"Financial and investment analysts",358,181,177,86736,91520,85436
2023,"Personal financial advisors",412,258,154,97968,108264,80704
2023,"Credit counselors and loan officers",304,139,165,70720,75764,67288
2023,"Other financial specialists",120,51,69,77012,124072,64116
2023,"Computer and mathematical occupations",6129,4522,1607,98280,102752,84656
2023,"Computer systems analysts",485,291,195,88452,98488,77324
2023,"Computer programmers",375,300,75,98228,99112,91520
2023,"Software developers",2104,1682,422,118716,119392,105040
2023,"Computer support specialists",616,454,162,74048,76856,70096
2023,"Computer occupations, all other",1104,833,271,83044,84812,74360
2023,"Operations research analysts",142,65,77,99684,114816,86580
2023,"Other mathematical science occupations",369,188,181,82940,86736,76648
2023,"Architecture and engineering occupations",3374,2821,553,92820,96928,85020
2023,"Architects, except landscape and naval",162,108,55,95212,98436,87932
2023,"Civil engineers",479,401,78,91104,95628,76180
2023,"Industrial engineers, including health and safety",278,209,69,90480,91832,87464
2023,"Engineers, all other",620,528,93,100776,101556,99008
2023,"Other engineering technologists and technicians, except drafters",359,296,63,63284,66924,51064
2023,"Life, physical, and social science occupations",1583,830,753,80132,86216,75140
2023,"Medical scientists",138,69,69,94952,119080,79924
2023,"Physical scientists, all other",399,220,179,90012,90584,85748
2023,"Other life, physical, and social science technicians",240,99,141,67912,74360,66300
2023,"Community and social service occupations",2334,735,1599,59644,60164,59488
2023,"Educational, guidance, and career counselors and advisors",338,73,264,60684,63804,60216
2023,"Counselors, all other",182,51,132,55640,64896,52572
2023,"Social workers, all other",654,113,541,64116,65156,63856
2023,"Social and human service assistants",200,54,146,50076,50284,50024
2023,"Legal occupations",1490,667,823,97760,119652,80236
2023,"Lawyers",887,514,374,126776,130260,121160
2023,"Paralegals and legal assistants",371,68,303,60268,74100,58500
2023,"Education, training, and library occupations",7524,2070,5455,61360,71552,58968
2023,"Postsecondary teachers",828,462,366,89596,96304,81380
2023,"Elementary and middle school teachers",3117,673,2444,64636,71240,63440
2023,"Secondary school teachers",859,367,493,66092,70044,63076
2023,"Other teachers and instructors",584,229,355,60580,64584,58448
2023,"Teaching assistants",940,184,757,36296,40144,35620
2023,"Arts, design, entertainment, sports, and media occupations",1858,1036,822,69836,71812,66092
2023,"Graphic designers",248,119,130,65156,67288,63492
2023,"Other designers",272,178,94,77064,77740,73216
2023,"Producers and directors",130,58,72,76284,68224,83668
2023,"Healthcare practitioners and technical occupations",7795,1963,5832,73008,87464,69732
2023,"Pharmacists",316,134,182,114816,116376,113360
2023,"Other physicians",715,398,317,151528,151840,151164
2023,"Physical therapists",234,89,145,83564,89180,79352
2023,"Registered nurses",2817,404,2413,74984,86164,73268
2023,"Clinical laboratory technologists and technicians",251,55,197,58084,60944,56628
2023,"Radiologic technologists and technicians",204,68,136,73424,77116,68692
2023,"Pharmacy technicians",244,55,189,46956,51584,46072
2023,"Licensed practical and licensed vocational nurses",479,59,420,51376,52936,51168
2023,"Healthcare support occupations",3467,578,2890,37076,41288,36608
2023,"Home health aides",330,59,271,33488,36868,32500
2023,"Personal care aides",903,190,713,35308,39052,34736
2023,"Nursing assistants",899,95,804,36400,39780,36140
2023,"Medical assistants",490,52,438,39104,47008,38376
2023,"Other healthcare support workers",187,64,124,43316,47788,41080
2023,"Protective service occupations",2706,2140,566,57876,61880,45968
2023,"Correctional officers and jailers",294,203,91,55796,58916,47528
2023,"Police officers",709,605,104,68640,70876,53768
2023,"Security guards and gambling surveillance officers",730,562,168,40976,42172,37284
2023,"Food preparation and serving related occupations",4325,2289,2036,34320,36400,32136
2023,"Chefs and head cooks",391,304,87,42432,44408,35880
2023,"First-line supervisors of food preparation and serving workers",432,215,217,37856,42588,35204
2023,"Cooks",1259,813,446,34060,35464,31616
2023,"Food preparation workers",484,220,264,32188,33540,31200
2023,"Bartenders",208,129,78,39728,39936,38740
2023,"Fast food and counter workers",288,109,179,31720,33228,30940
2023,"Waiters and waitresses",828,281,547,33384,35568,32084
2023,"Dining room and cafeteria attendants and bartender helpers",132,62,69,30836,31564,30576
2023,"Building and grounds cleaning and maintenance occupations",3520,2161,1359,35984,38948,32292
2023,"First-line supervisors of housekeeping and janitorial workers",177,100,77,46592,54600,36348
2023,"Janitors and building cleaners",1505,999,505,36192,38740,32552
2023,"Maids and housekeeping cleaners",834,113,721,32188,35672,31772
2023,"Personal care and service occupations",1799,505,1294,37700,40508,36712
2023,"Recreation workers",129,56,74,40352,41652,37232
2023,"Sales and related occupations",9148,5099,4049,52052,62192,43160
2023,"First-line supervisors of retail sales workers",2234,1274,960,51740,56888,47008
2023,"First-line supervisors of non-retail sales workers",906,538,367,69940,76128,59852
2023,"Cashiers",1147,346,801,31512,32032,31304
2023,"Retail salespersons",1585,963,622,43108,51376,36920
2023,"Advertising sales agents",101,51,50,74984,89856,72696
2023,"Insurance sales agents",443,183,260,56212,68120,48204
2023,"Securities, commodities, and financial services sales agents",184,129,55,120640,125424,86008
2023,"Sales representatives of services, except advertising, insurance, financial services, and travel",577,399,178,70980,75452,59124
2023,"Sales representatives, wholesale and manufacturing",999,731,268,74204,79820,63180
2023,"Real estate brokers and sales agents",440,188,252,70876,75088,63180
2023,"Sales and related workers, all other",213,105,108,47528,52988,41964
2023,"Office and administrative support occupations",12519,3777,8743,46332,51116,44928
2023,"First-line supervisors of office and administrative support workers",1038,351,687,57928,62868,55900
2023,"Bookkeeping, accounting, and auditing clerks",869,130,738,49036,57200,47944
2023,"Financial clerks, all other",121,57,65,56056,69420,52468
2023,"Customer service representatives",2157,731,1426,43056,47736,41548
2023,"Receptionists and information clerks",827,112,715,39104,40040,38948
2023,"Couriers and messengers",547,435,112,44356,46020,36972
2023,"Dispatchers, except police, fire, and ambulance",156,65,91,46696,58656,44304
2023,"Postal service mail carriers",279,182,97,58760,62088,52780
2023,"Production, planning, and expediting clerks",198,109,89,69368,69420,69316
2023,"Shipping, receiving, and inventory clerks",555,356,199,42172,43004,41028
2023,"Secretaries and administrative assistants, except legal, medical, and executive",1387,130,1257,46488,57252,45864
2023,"Data entry keyers",185,59,126,42328,42588,42068
2023,"Insurance claims and policy processing clerks",265,59,206,47424,55224,46592
2023,"Office clerks, general",926,176,750,43056,45084,42848
2023,"Office and administrative support workers, all other",380,134,246,52364,53976,51376
2023,"Natural resources, construction, and maintenance occupations",11368,10793,575,52052,52676,38168
2023,"Farming, fishing, and forestry occupations",731,548,183,35828,37856,31928
2023,"Miscellaneous agricultural workers",542,412,130,34424,36608,31096
2023,"Construction and extraction occupations",6517,6277,240,51220,51532,41340
2023,"Construction laborers",1572,1498,74,44616,45240,36972
2023,"Installation, maintenance, and repair occupations",4120,3968,152,56784,57408,45500
2023,"Production occupations",7313,5277,2036,46540,50232,38584
2023,"First-line supervisors of production and operating workers",714,560,154,61100,65676,47528
2023,"Electrical, electronics, and electromechanical assemblers",115,61,54,42848,46124,40664
2023,"Other assemblers and fabricators",961,607,355,42224,44304,39416
2023,"Bakers",139,58,81,34840,37752,34112
2023,"Butchers and other meat, poultry, and fish processing workers",231,161,69,39884,42536,36192
2023,"Other metal workers and plastic workers",347,278,69,44460,47112,35568
2023,"Inspectors, testers, sorters, samplers, and weighers",718,436,282,47892,52520,42068
2023,"Packaging and filling machine operators and tenders",264,117,147,37232,39104,36296
2023,"Other production workers",1162,862,301,44512,46436,40092
2023,"Transportation and material moving occupations",8664,7013,1651,43732,46644,36088
2023,"Supervisors of transportation and material moving workers",313,235,78,52832,58604,41132
2023,"Bus drivers, transit and intercity",224,150,74,47372,50908,42172
2023,"Driver/sales workers and truck drivers",2709,2560,149,52260,52832,38168
2023,"Industrial truck and tractor operators",583,526,57,42068,42224,40872
2023,"Cleaners of vehicles and equipment",299,242,57,36088,36608,31460
2023,"Laborers and freight, stock, and material movers, hand",1584,1235,349,39780,41652,35620
2023,"Packers and packagers, hand",484,229,255,36296,38064,34684
2023,"Stockers and order fillers",1084,729,355,36712,37960,34684
